State,StateFIPS,CountyFIPS,AreaName,All_Poverty,M_Poverty,F_Poverty
AK,02,013,"Aleutians East Borough, Alaska",553,334,219
AK,02,016,"Aleutians West Census Area, Alaska",499,273,226
AK,02,020,"Anchorage Municipality, Alaska",23914,10698,13216
AK,02,050,"Bethel Census Area, Alaska",4364,2199,2165
AK,02,060,"Bristol Bay Borough, Alaska",69,33,36
AK,02,068,"Denali Borough, Alaska",254,139,115
AK,02,070,"Dillingham Census Area, Alaska",894,446,448
AK,02,090,"Fairbanks North Star Borough, Alaska",7752,3523,4229
AK,02,100,"Haines Borough, Alaska",135,74,61
AK,02,105,"Hoonah-Angoon Census Area, Alaska",252,102,150
AK,02,110,"Juneau City and Borough, Alaska",2110,1145,965
AK,02,122,"Kenai Peninsula Borough, Alaska",5558,2596,2962
AK,02,130,"Ketchikan Gateway Borough, Alaska",1640,792,848
AK,02,150,"Kodiak Island Borough, Alaska",1552,962,590
AK,02,158,"Kusilvak Census Area, Alaska",2622,1290,1332
AK,02,164,"Lake and Peninsula Borough, Alaska",247,119,128
AK,02,170,"Matanuska-Susitna Borough, Alaska",9454,4346,5108
AK,02,180,"Nome Census Area, Alaska",2592,1399,1193
AK,02,185,"North Slope Borough, Alaska",976,532,444
AK,02,188,"Northwest Arctic Borough, Alaska",1824,951,873
AK,02,195,"Petersburg Borough, Alaska",327,174,153
AK,02,198,"Prince of Wales-Hyder Census Area, Alaska",921,475,446
AK,02,220,"Sitka City and Borough, Alaska",798,424,374
AK,02,230,"Skagway Municipality, Alaska",44,16,28
AK,02,240,"Southeast Fairbanks Census Area, Alaska",1011,507,504
AK,02,261,"Valdez-Cordova Census Area, Alaska",1029,598,431
AK,02,275,"Wrangell City and Borough, Alaska",279,153,126
AK,02,282,"Yakutat City and Borough, Alaska",35,25,10
AK,02,290,"Yukon-Koyukuk Census Area, Alaska",1252,666,586
AL,01,001,"Autauga County, Alabama",7057,2983,4074
AL,01,003,"Baldwin County, Alabama",25798,12018,13780
AL,01,005,"Barbour County, Alabama",6421,2856,3565
AL,01,007,"Bibb County, Alabama",3488,1495,1993
AL,01,009,"Blount County, Alabama",9552,4593,4959
AL,01,011,"Bullock County, Alabama",2486,981,1505
AL,01,013,"Butler County, Alabama",5094,2073,3021
AL,01,015,"Calhoun County, Alabama",23325,9500,13825
AL,01,017,"Chambers County, Alabama",7273,3091,4182
AL,01,019,"Cherokee County, Alabama",4918,2421,2497
AL,01,021,"Chilton County, Alabama",8288,3871,4417
AL,01,023,"Choctaw County, Alabama",3093,1206,1887
AL,01,025,"Clarke County, Alabama",6107,2495,3612
AL,01,027,"Clay County, Alabama",2201,902,1299
AL,01,029,"Cleburne County, Alabama",2508,1069,1439
AL,01,031,"Coffee County, Alabama",8581,3867,4714
AL,01,033,"Colbert County, Alabama",9406,4124,5282
AL,01,035,"Conecuh County, Alabama",4320,2011,2309
AL,01,037,"Coosa County, Alabama",2073,961,1112
AL,01,039,"Covington County, Alabama",7515,3263,4252
AL,01,041,"Crenshaw County, Alabama",2288,1068,1220
AL,01,043,"Cullman County, Alabama",14814,6760,8054
AL,01,045,"Dale County, Alabama",9306,4092,5214
AL,01,047,"Dallas County, Alabama",14580,5889,8691
AL,01,049,"DeKalb County, Alabama",13133,5783,7350
AL,01,051,"Elmore County, Alabama",10334,4413,5921
AL,01,053,"Escambia County, Alabama",8609,3695,4914
AL,01,055,"Etowah County, Alabama",20078,8854,11224
AL,01,057,"Fayette County, Alabama",3055,1449,1606
AL,01,059,"Franklin County, Alabama",7020,2598,4422
AL,01,061,"Geneva County, Alabama",6149,2689,3460
AL,01,063,"Greene County, Alabama",3479,1562,1917
AL,01,065,"Hale County, Alabama",4011,1638,2373
AL,01,067,"Henry County, Alabama",2657,1085,1572
AL,01,069,"Houston County, Alabama",18746,7893,10853
AL,01,071,"Jackson County, Alabama",9415,4398,5017
AL,01,073,"Jefferson County, Alabama",121029,52750,68279
AL,01,075,"Lamar County, Alabama",3382,1302,2080
AL,01,077,"Lauderdale County, Alabama",16232,6772,9460
AL,01,079,"Lawrence County, Alabama",6225,2780,3445
AL,01,081,"Lee County, Alabama",34561,15869,18692
AL,01,083,"Limestone County, Alabama",12075,5206,6869
AL,01,085,"Lowndes County, Alabama",3035,1353,1682
AL,01,087,"Macon County, Alabama",4636,2060,2576
AL,01,089,"Madison County, Alabama",46436,21195,25241
AL,01,091,"Marengo County, Alabama",5244,2056,3188
AL,01,093,"Marion County, Alabama",5960,2805,3155
AL,01,095,"Marshall County, Alabama",18794,8426,10368
AL,01,097,"Mobile County, Alabama",77917,31927,45990
AL,01,099,"Monroe County, Alabama",6901,2912,3989
AL,01,101,"Montgomery County, Alabama",49918,21699,28219
AL,01,103,"Morgan County, Alabama",18936,7640,11296
AL,01,105,"Perry County, Alabama",3373,1510,1863
AL,01,107,"Pickens County, Alabama",4801,2116,2685
AL,01,109,"Pike County, Alabama",8158,3810,4348
AL,01,111,"Randolph County, Alabama",4511,2048,2463
AL,01,113,"Russell County, Alabama",12054,4782,7272
AL,01,115,"St. Clair County, Alabama",13417,6115,7302
AL,01,117,"Shelby County, Alabama",16693,7492,9201
AL,01,119,"Sumter County, Alabama",5372,2187,3185
AL,01,121,"Talladega County, Alabama",17950,7613,10337
AL,01,123,"Tallapoosa County, Alabama",9117,3646,5471
AL,01,125,"Tuscaloosa County, Alabama",36274,15124,21150
AL,01,127,"Walker County, Alabama",14598,6480,8118
AL,01,129,"Washington County, Alabama",3200,1367,1833
AL,01,131,"Wilcox County, Alabama",4126,1910,2216
AL,01,133,"Winston County, Alabama",5157,2035,3122
AR,05,001,"Arkansas County, Arkansas",3705,1514,2191
AR,05,003,"Ashley County, Arkansas",4352,1961,2391
AR,05,005,"Baxter County, Arkansas",6452,3062,3390
AR,05,007,"Benton County, Arkansas",28804,13213,15591
AR,05,009,"Boone County, Arkansas",6465,2751,3714
AR,05,011,"Bradley County, Arkansas",3218,1350,1868
AR,05,013,"Calhoun County, Arkansas",907,409,498
AR,05,015,"Carroll County, Arkansas",5001,2173,2828
AR,05,017,"Chicot County, Arkansas",3385,1350,2035
AR,05,019,"Clark County, Arkansas",4716,1872,2844
AR,05,021,"Clay County, Arkansas",3324,1472,1852
AR,05,023,"Cleburne County, Arkansas",3676,1696,1980
AR,05,025,"Cleveland County, Arkansas",1751,785,966
AR,05,027,"Columbia County, Arkansas",5823,2540,3283
AR,05,029,"Conway County, Arkansas",4709,2344,2365
AR,05,031,"Craighead County, Arkansas",19715,8920,10795
AR,05,033,"Crawford County, Arkansas",11304,5456,5848
AR,05,035,"Crittenden County, Arkansas",11802,4745,7057
AR,05,037,"Cross County, Arkansas",3461,1459,2002
AR,05,039,"Dallas County, Arkansas",1141,521,620
AR,05,041,"Desha County, Arkansas",4029,1628,2401
AR,05,043,"Drew County, Arkansas",5023,2381,2642
AR,05,045,"Faulkner County, Arkansas",17768,7625,10143
AR,05,047,"Franklin County, Arkansas",3854,1651,2203
AR,05,049,"Fulton County, Arkansas",2383,1094,1289
AR,05,051,"Garland County, Arkansas",19802,9205,10597
AR,05,053,"Grant County, Arkansas",2134,943,1191
AR,05,055,"Greene County, Arkansas",7572,3161,4411
AR,05,057,"Hempstead County, Arkansas",5940,2685,3255
AR,05,059,"Hot Spring County, Arkansas",5975,2520,3455
AR,05,061,"Howard County, Arkansas",2910,1276,1634
AR,05,063,"Independence County, Arkansas",7783,3287,4496
AR,05,065,"Izard County, Arkansas",2663,1346,1317
AR,05,067,"Jackson County, Arkansas",3819,1759,2060
AR,05,069,"Jefferson County, Arkansas",17205,7764,9441
AR,05,071,"Johnson County, Arkansas",5574,2492,3082
AR,05,073,"Lafayette County, Arkansas",1731,692,1039
AR,05,075,"Lawrence County, Arkansas",3899,1796,2103
AR,05,077,"Lee County, Arkansas",2304,969,1335
AR,05,079,"Lincoln County, Arkansas",2257,1003,1254
AR,05,081,"Little River County, Arkansas",2402,1074,1328
AR,05,083,"Logan County, Arkansas",4158,1995,2163
AR,05,085,"Lonoke County, Arkansas",8697,3814,4883
AR,05,087,"Madison County, Arkansas",3183,1329,1854
AR,05,089,"Marion County, Arkansas",3064,1345,1719
AR,05,091,"Miller County, Arkansas",8594,3519,5075
AR,05,093,"Mississippi County, Arkansas",11781,4964,6817
AR,05,095,"Monroe County, Arkansas",2501,1078,1423
AR,05,097,"Montgomery County, Arkansas",1620,728,892
AR,05,099,"Nevada County, Arkansas",2424,1176,1248
AR,05,101,"Newton County, Arkansas",1637,648,989
AR,05,103,"Ouachita County, Arkansas",5948,2211,3737
AR,05,105,"Perry County, Arkansas",1624,509,1115
AR,05,107,"Phillips County, Arkansas",6882,2991,3891
AR,05,109,"Pike County, Arkansas",2199,999,1200
AR,05,111,"Poinsett County, Arkansas",5416,2410,3006
AR,05,113,"Polk County, Arkansas",4878,2389,2489
AR,05,115,"Pope County, Arkansas",11818,5525,6293
AR,05,117,"Prairie County, Arkansas",1766,775,991
AR,05,119,"Pulaski County, Arkansas",67908,30871,37037
AR,05,121,"Randolph County, Arkansas",3651,1897,1754
AR,05,123,"St. Francis County, Arkansas",5857,2661,3196
AR,05,125,"Saline County, Arkansas",10176,4896,5280
AR,05,127,"Scott County, Arkansas",2165,1061,1104
AR,05,129,"Searcy County, Arkansas",1855,986,869
AR,05,131,"Sebastian County, Arkansas",28975,12570,16405
AR,05,133,"Sevier County, Arkansas",3755,1807,1948
AR,05,135,"Sharp County, Arkansas",3944,1700,2244
AR,05,137,"Stone County, Arkansas",3042,1414,1628
AR,05,139,"Union County, Arkansas",8172,3577,4595
AR,05,141,"Van Buren County, Arkansas",3574,1438,2136
AR,05,143,"Washington County, Arkansas",41846,19505,22341
AR,05,145,"White County, Arkansas",14175,6412,7763
AR,05,147,"Woodruff County, Arkansas",1612,740,872
AR,05,149,"Yell County, Arkansas",4009,1862,2147
AZ,04,001,"Apache County, Arizona",25852,12854,12998
AZ,04,003,"Cochise County, Arizona",21102,8595,12507
AZ,04,005,"Coconino County, Arizona",28824,13662,15162
AZ,04,007,"Gila County, Arizona",11839,5365,6474
AZ,04,009,"Graham County, Arizona",7446,3377,4069
AZ,04,011,"Greenlee County, Arizona",1215,538,677
AZ,04,012,"La Paz County, Arizona",3824,1851,1973
AZ,04,013,"Maricopa County, Arizona",673527,313707,359820
AZ,04,015,"Mohave County, Arizona",38874,18410,20464
AZ,04,017,"Navajo County, Arizona",32141,15025,17116
AZ,04,019,"Pima County, Arizona",187250,86251,100999
AZ,04,021,"Pinal County, Arizona",63201,28120,35081
AZ,04,023,"Santa Cruz County, Arizona",10970,5162,5808
AZ,04,025,"Yavapai County, Arizona",34117,16249,17868
AZ,04,027,"Yuma County, Arizona",40508,18351,22157
CA,06,001,"Alameda County, California",194639,87343,107296
CA,06,003,"Alpine County, California",195,106,89
CA,06,005,"Amador County, California",4191,1886,2305
CA,06,007,"Butte County, California",47532,23533,23999
CA,06,009,"Calaveras County, California",5590,2433,3157
CA,06,011,"Colusa County, California",3171,1590,1581
CA,06,013,"Contra Costa County, California",117915,52269,65646
CA,06,015,"Del Norte County, California",5207,2385,2822
CA,06,017,"El Dorado County, California",18831,9082,9749
CA,06,019,"Fresno County, California",252187,117772,134415
CA,06,021,"Glenn County, California",5721,2544,3177
CA,06,023,"Humboldt County, California",28158,13202,14956
CA,06,025,"Imperial County, California",40114,18036,22078
CA,06,027,"Inyo County, California",2019,907,1112
CA,06,029,"Kern County, California",195744,87585,108159
CA,06,031,"Kings County, California",29900,13392,16508
CA,06,033,"Lake County, California",15597,7932,7665
CA,06,035,"Lassen County, California",3563,1814,1749
CA,06,037,"Los Angeles County, California",1800265,823612,976653
CA,06,039,"Madera County, California",33968,15721,18247
CA,06,041,"Marin County, California",20964,9707,11257
CA,06,043,"Mariposa County, California",2651,1264,1387
CA,06,045,"Mendocino County, California",17527,8215,9312
CA,06,047,"Merced County, California",67417,32269,35148
CA,06,049,"Modoc County, California",1673,833,840
CA,06,051,"Mono County, California",684,344,340
CA,06,053,"Monterey County, California",69475,31992,37483
CA,06,055,"Napa County, California",14020,6923,7097
CA,06,057,"Nevada County, California",12367,5582,6785
CA,06,059,"Orange County, California",395483,182267,213216
CA,06,061,"Placer County, California",32427,15480,16947
CA,06,063,"Plumas County, California",2687,1168,1519
CA,06,065,"Riverside County, California",379985,175705,204280
CA,06,067,"Sacramento County, California",262251,122854,139397
CA,06,069,"San Benito County, California",6202,2722,3480
CA,06,071,"San Bernardino County, California",397766,178898,218868
CA,06,073,"San Diego County, California",454876,210952,243924
CA,06,075,"San Francisco County, California",109524,52571,56953
CA,06,077,"San Joaquin County, California",129390,59724,69666
CA,06,079,"San Luis Obispo County, California",38630,18816,19814
CA,06,081,"San Mateo County, California",59232,26750,32482
CA,06,083,"Santa Barbara County, California",68017,32772,35245
CA,06,085,"Santa Clara County, California",175690,81461,94229
CA,06,087,"Santa Cruz County, California",39053,17482,21571
CA,06,089,"Shasta County, California",31707,14584,17123
CA,06,091,"Sierra County, California",438,180,258
CA,06,093,"Siskiyou County, California",10026,4814,5212
CA,06,095,"Solano County, California",55534,24891,30643
CA,06,097,"Sonoma County, California",57179,26643,30536
CA,06,099,"Stanislaus County, California",105927,48153,57774
CA,06,101,"Sutter County, California",16743,7675,9068
CA,06,103,"Tehama County, California",12313,5604,6709
CA,06,105,"Trinity County, California",2562,1226,1336
CA,06,107,"Tulare County, California",125775,60834,64941
CA,06,109,"Tuolumne County, California",7010,3092,3918
CA,06,111,"Ventura County, California",91880,42180,49700
CA,06,113,"Yolo County, California",39688,18185,21503
CA,06,115,"Yuba County, California",15862,7384,8478
CO,08,001,"Adams County, Colorado",64241,29134,35107
CO,08,003,"Alamosa County, Colorado",4396,1771,2625
CO,08,005,"Arapahoe County, Colorado",67679,31140,36539
CO,08,007,"Archuleta County, Colorado",1405,661,744
CO,08,009,"Baca County, Colorado",736,308,428
CO,08,011,"Bent County, Colorado",923,473,450
CO,08,013,"Boulder County, Colorado",42167,20822,21345
CO,08,014,"Broomfield County, Colorado",3930,1582,2348
CO,08,015,"Chaffee County, Colorado",1502,647,855
CO,08,017,"Cheyenne County, Colorado",168,78,90
CO,08,019,"Clear Creek County, Colorado",748,352,396
CO,08,021,"Conejos County, Colorado",1491,735,756
CO,08,023,"Costilla County, Colorado",850,354,496
CO,08,025,"Crowley County, Colorado",1449,587,862
CO,08,027,"Custer County, Colorado",736,385,351
CO,08,029,"Delta County, Colorado",4716,2086,2630
CO,08,031,"Denver County, Colorado",110299,52215,58084
CO,08,033,"Dolores County, Colorado",398,218,180
CO,08,035,"Douglas County, Colorado",12110,5653,6457
CO,08,037,"Eagle County, Colorado",4780,2769,2011
CO,08,039,"Elbert County, Colorado",1649,819,830
CO,08,041,"El Paso County, Colorado",75033,33973,41060
CO,08,043,"Fremont County, Colorado",6272,2828,3444
CO,08,045,"Garfield County, Colorado",6786,3452,3334
CO,08,047,"Gilpin County, Colorado",413,188,225
CO,08,049,"Grand County, Colorado",1543,733,810
CO,08,051,"Gunnison County, Colorado",2509,1163,1346
CO,08,053,"Hinsdale County, Colorado",70,34,36
CO,08,055,"Huerfano County, Colorado",1171,646,525
CO,08,057,"Jackson County, Colorado",155,71,84
CO,08,059,"Jefferson County, Colorado",46423,20756,25667
CO,08,061,"Kiowa County, Colorado",189,68,121
CO,08,063,"Kit Carson County, Colorado",1157,444,713
CO,08,065,"Lake County, Colorado",833,373,460
CO,08,067,"La Plata County, Colorado",5432,2273,3159
CO,08,069,"Larimer County, Colorado",42338,19766,22572
CO,08,071,"Las Animas County, Colorado",2055,1039,1016
CO,08,073,"Lincoln County, Colorado",624,223,401
CO,08,075,"Logan County, Colorado",3529,1745,1784
CO,08,077,"Mesa County, Colorado",22545,10438,12107
CO,08,079,"Mineral County, Colorado",56,18,38
CO,08,081,"Moffat County, Colorado",1462,703,759
CO,08,083,"Montezuma County, Colorado",4550,2193,2357
CO,08,085,"Montrose County, Colorado",7644,3476,4168
CO,08,087,"Morgan County, Colorado",3218,1172,2046
CO,08,089,"Otero County, Colorado",4396,2097,2299
CO,08,091,"Ouray County, Colorado",355,174,181
CO,08,093,"Park County, Colorado",1170,563,607
CO,08,095,"Phillips County, Colorado",658,293,365
CO,08,097,"Pitkin County, Colorado",1709,663,1046
CO,08,099,"Prowers County, Colorado",2264,993,1271
CO,08,101,"Pueblo County, Colorado",31017,14201,16816
CO,08,103,"Rio Blanco County, Colorado",1113,521,592
CO,08,105,"Rio Grande County, Colorado",2198,1070,1128
CO,08,107,"Routt County, Colorado",2369,1338,1031
CO,08,109,"Saguache County, Colorado",1450,609,841
CO,08,111,"San Juan County, Colorado",100,48,52
CO,08,113,"San Miguel County, Colorado",854,398,456
CO,08,115,"Sedgwick County, Colorado",335,138,197
CO,08,117,"Summit County, Colorado",3949,1928,2021
CO,08,119,"Teller County, Colorado",1728,826,902
CO,08,121,"Washington County, Colorado",466,184,282
CO,08,123,"Weld County, Colorado",34007,15469,18538
CO,08,125,"Yuma County, Colorado",1451,599,852
CT,09,001,"Fairfield County, Connecticut",82743,36089,46654
CT,09,003,"Hartford County, Connecticut",104196,46770,57426
CT,09,005,"Litchfield County, Connecticut",12893,6253,6640
CT,09,007,"Middlesex County, Connecticut",10710,4712,5998
CT,09,009,"New Haven County, Connecticut",108533,46592,61941
CT,09,011,"New London County, Connecticut",25766,11243,14523
CT,09,013,"Tolland County, Connecticut",9511,4404,5107
CT,09,015,"Windham County, Connecticut",11999,4937,7062
DC,11,001,"District of Columbia, District of Columbia",110365,48069,62296
DE,10,001,"Kent County, Delaware",22074,9294,12780
DE,10,003,"New Castle County, Delaware",60487,25747,34740
DE,10,005,"Sussex County, Delaware",25754,11078,14676
FL,12,001,"Alachua County, Florida",58203,27526,30677
FL,12,003,"Baker County, Florida",4393,1849,2544
FL,12,005,"Bay County, Florida",26235,11556,14679
FL,12,007,"Bradford County, Florida",4896,2208,2688
FL,12,009,"Brevard County, Florida",76460,35131,41329
FL,12,011,"Broward County, Florida",265880,119303,146577
FL,12,013,"Calhoun County, Florida",2407,1034,1373
FL,12,015,"Charlotte County, Florida",19760,8772,10988
FL,12,017,"Citrus County, Florida",23903,10602,13301
FL,12,019,"Clay County, Florida",20580,9158,11422
FL,12,021,"Collier County, Florida",47436,22674,24762
FL,12,023,"Columbia County, Florida",12498,5458,7040
FL,12,027,"DeSoto County, Florida",10123,5668,4455
FL,12,029,"Dixie County, Florida",3061,1320,1741
FL,12,031,"Duval County, Florida",150792,66314,84478
FL,12,033,"Escambia County, Florida",45308,20987,24321
FL,12,035,"Flagler County, Florida",14814,6979,7835
FL,12,037,"Franklin County, Florida",1977,872,1105
FL,12,039,"Gadsden County, Florida",11907,5937,5970
FL,12,041,"Gilchrist County, Florida",3598,1705,1893
FL,12,043,"Glades County, Florida",2408,1150,1258
FL,12,045,"Gulf County, Florida",1924,830,1094
FL,12,047,"Hamilton County, Florida",3234,1467,1767
FL,12,049,"Hardee County, Florida",7029,3262,3767
FL,12,051,"Hendry County, Florida",9696,4898,4798
FL,12,053,"Hernando County, Florida",27375,12662,14713
FL,12,055,"Highlands County, Florida",18863,9056,9807
FL,12,057,"Hillsborough County, Florida",217684,98476,119208
FL,12,059,"Holmes County, Florida",4903,2374,2529
FL,12,061,"Indian River County, Florida",20272,8950,11322
FL,12,063,"Jackson County, Florida",9090,4056,5034
FL,12,065,"Jefferson County, Florida",1862,741,1121
FL,12,067,"Lafayette County, Florida",1425,563,862
FL,12,069,"Lake County, Florida",42497,19644,22853
FL,12,071,"Lee County, Florida",105166,48604,56562
FL,12,073,"Leon County, Florida",60286,28018,32268
FL,12,075,"Levy County, Florida",8601,4159,4442
FL,12,077,"Liberty County, Florida",1237,711,526
FL,12,079,"Madison County, Florida",4269,1989,2280
FL,12,081,"Manatee County, Florida",51595,23144,28451
FL,12,083,"Marion County, Florida",60207,26829,33378
FL,12,085,"Martin County, Florida",17965,8725,9240
FL,12,086,"Miami-Dade County, Florida",530006,234079,295927
FL,12,087,"Monroe County, Florida",9998,4952,5046
FL,12,089,"Nassau County, Florida",9652,4524,5128
FL,12,091,"Okaloosa County, Florida",24595,11057,13538
FL,12,093,"Okeechobee County, Florida",9965,4747,5218
FL,12,095,"Orange County, Florida",212489,96829,115660
FL,12,097,"Osceola County, Florida",58146,26746,31400
FL,12,099,"Palm Beach County, Florida",197340,88523,108817
FL,12,101,"Pasco County, Florida",66144,29154,36990
FL,12,103,"Pinellas County, Florida",131643,58929,72714
FL,12,105,"Polk County, Florida",111877,50847,61030
FL,12,107,"Putnam County, Florida",20397,9041,11356
FL,12,109,"St. Johns County, Florida",19706,8625,11081
FL,12,111,"St. Lucie County, Florida",52201,24225,27976
FL,12,113,"Santa Rosa County, Florida",19063,8482,10581
FL,12,115,"Sarasota County, Florida",42386,19475,22911
FL,12,117,"Seminole County, Florida",52637,24575,28062
FL,12,119,"Sumter County, Florida",10802,4602,6200
FL,12,121,"Suwannee County, Florida",10012,4500,5512
FL,12,123,"Taylor County, Florida",2720,1226,1494
FL,12,125,"Union County, Florida",2002,814,1188
FL,12,127,"Volusia County, Florida",85881,39086,46795
FL,12,129,"Wakulla County, Florida",4101,1658,2443
FL,12,131,"Walton County, Florida",9804,5087,4717
FL,12,133,"Washington County, Florida",4723,2407,2316
GA,13,001,"Appling County, Georgia",3745,1485,2260
GA,13,003,"Atkinson County, Georgia",2370,1068,1302
GA,13,005,"Bacon County, Georgia",1919,850,1069
GA,13,007,"Baker County, Georgia",752,287,465
GA,13,009,"Baldwin County, Georgia",13201,5601,7600
GA,13,011,"Banks County, Georgia",3026,1497,1529
GA,13,013,"Barrow County, Georgia",10902,5099,5803
GA,13,015,"Bartow County, Georgia",15819,6659,9160
GA,13,017,"Ben Hill County, Georgia",6024,2511,3513
GA,13,019,"Berrien County, Georgia",4923,2088,2835
GA,13,021,"Bibb County, Georgia",40611,16798,23813
GA,13,023,"Bleckley County, Georgia",2616,1270,1346
GA,13,025,"Brantley County, Georgia",3812,1561,2251
GA,13,027,"Brooks County, Georgia",4265,1864,2401
GA,13,029,"Bryan County, Georgia",4487,1939,2548
GA,13,031,"Bulloch County, Georgia",21794,10148,11646
GA,13,033,"Burke County, Georgia",7131,3099,4032
GA,13,035,"Butts County, Georgia",4329,2023,2306
GA,13,037,"Calhoun County, Georgia",1924,891,1033
GA,13,039,"Camden County, Georgia",6365,2795,3570
GA,13,043,"Candler County, Georgia",3398,1480,1918
GA,13,045,"Carroll County, Georgia",22441,9360,13081
GA,13,047,"Catoosa County, Georgia",8061,3588,4473
GA,13,049,"Charlton County, Georgia",2010,1140,870
GA,13,051,"Chatham County, Georgia",50980,21510,29470
GA,13,053,"Chattahoochee County, Georgia",960,569,391
GA,13,055,"Chattooga County, Georgia",5488,2243,3245
GA,13,057,"Cherokee County, Georgia",24273,11323,12950
GA,13,059,"Clarke County, Georgia",40559,18801,21758
GA,13,061,"Clay County, Georgia",1285,579,706
GA,13,063,"Clayton County, Georgia",65787,29093,36694
GA,13,065,"Clinch County, Georgia",2339,915,1424
GA,13,067,"Cobb County, Georgia",87880,40060,47820
GA,13,069,"Coffee County, Georgia",9975,4089,5886
GA,13,071,"Colquitt County, Georgia",12086,5622,6464
GA,13,073,"Columbia County, Georgia",12517,5247,7270
GA,13,075,"Cook County, Georgia",4244,1837,2407
GA,13,077,"Coweta County, Georgia",17489,7061,10428
GA,13,079,"Crawford County, Georgia",2122,984,1138
GA,13,081,"Crisp County, Georgia",7468,3161,4307
GA,13,083,"Dade County, Georgia",2300,986,1314
GA,13,085,"Dawson County, Georgia",3156,1372,1784
GA,13,087,"Decatur County, Georgia",7418,3071,4347
GA,13,089,"DeKalb County, Georgia",135469,61067,74402
GA,13,091,"Dodge County, Georgia",4279,2065,2214
GA,13,093,"Dooly County, Georgia",3673,1729,1944
GA,13,095,"Dougherty County, Georgia",27557,11753,15804
GA,13,097,"Douglas County, Georgia",22118,9856,12262
GA,13,099,"Early County, Georgia",2916,1293,1623
GA,13,101,"Echols County, Georgia",1170,436,734
GA,13,103,"Effingham County, Georgia",5749,2473,3276
GA,13,105,"Elbert County, Georgia",3664,1459,2205
GA,13,107,"Emanuel County, Georgia",6700,3151,3549
GA,13,109,"Evans County, Georgia",2857,1127,1730
GA,13,111,"Fannin County, Georgia",5404,2047,3357
GA,13,113,"Fayette County, Georgia",9129,3883,5246
GA,13,115,"Floyd County, Georgia",19605,9048,10557
GA,13,117,"Forsyth County, Georgia",13547,5932,7615
GA,13,119,"Franklin County, Georgia",5122,2253,2869
GA,13,121,"Fulton County, Georgia",167391,72577,94814
GA,13,123,"Gilmer County, Georgia",6664,3541,3123
GA,13,125,"Glascock County, Georgia",483,237,246
GA,13,127,"Glynn County, Georgia",14981,6339,8642
GA,13,129,"Gordon County, Georgia",11188,5321,5867
GA,13,131,"Grady County, Georgia",7648,3529,4119
GA,13,133,"Greene County, Georgia",4033,1870,2163
GA,13,135,"Gwinnett County, Georgia",117553,54558,62995
GA,13,137,"Habersham County, Georgia",7220,3357,3863
GA,13,139,"Hall County, Georgia",34120,16393,17727
GA,13,141,"Hancock County, Georgia",2113,835,1278
GA,13,143,"Haralson County, Georgia",5724,2583,3141
GA,13,145,"Harris County, Georgia",2991,1317,1674
GA,13,147,"Hart County, Georgia",5403,2421,2982
GA,13,149,"Heard County, Georgia",2349,1048,1301
GA,13,151,"Henry County, Georgia",27162,11870,15292
GA,13,153,"Houston County, Georgia",25111,10623,14488
GA,13,155,"Irwin County, Georgia",2300,1081,1219
GA,13,157,"Jackson County, Georgia",8314,3770,4544
GA,13,159,"Jasper County, Georgia",2785,1269,1516
GA,13,161,"Jeff Davis County, Georgia",3309,1383,1926
GA,13,163,"Jefferson County, Georgia",4889,2228,2661
GA,13,165,"Jenkins County, Georgia",2984,1335,1649
GA,13,167,"Johnson County, Georgia",2125,1064,1061
GA,13,169,"Jones County, Georgia",4770,2119,2651
GA,13,171,"Lamar County, Georgia",3713,1794,1919
GA,13,173,"Lanier County, Georgia",2675,1226,1449
GA,13,175,"Laurens County, Georgia",12823,5604,7219
GA,13,177,"Lee County, Georgia",3417,1356,2061
GA,13,179,"Liberty County, Georgia",11047,4963,6084
GA,13,181,"Lincoln County, Georgia",1912,799,1113
GA,13,183,"Long County, Georgia",2936,1244,1692
GA,13,185,"Lowndes County, Georgia",28907,13270,15637
GA,13,187,"Lumpkin County, Georgia",5559,2398,3161
GA,13,189,"McDuffie County, Georgia",5410,2397,3013
GA,13,191,"McIntosh County, Georgia",2956,1296,1660
GA,13,193,"Macon County, Georgia",3639,1541,2098
GA,13,195,"Madison County, Georgia",4798,2176,2622
GA,13,197,"Marion County, Georgia",1836,640,1196
GA,13,199,"Meriwether County, Georgia",4733,2135,2598
GA,13,201,"Miller County, Georgia",1608,648,960
GA,13,205,"Mitchell County, Georgia",5905,2385,3520
GA,13,207,"Monroe County, Georgia",3492,1480,2012
GA,13,209,"Montgomery County, Georgia",2076,979,1097
GA,13,211,"Morgan County, Georgia",2529,1047,1482
GA,13,213,"Murray County, Georgia",7765,3685,4080
GA,13,215,"Muscogee County, Georgia",38921,16697,22224
GA,13,217,"Newton County, Georgia",17281,7478,9803
GA,13,219,"Oconee County, Georgia",2487,1084,1403
GA,13,221,"Oglethorpe County, Georgia",2316,1054,1262
GA,13,223,"Paulding County, Georgia",18445,7439,11006
GA,13,225,"Peach County, Georgia",5471,2439,3032
GA,13,227,"Pickens County, Georgia",3418,1479,1939
GA,13,229,"Pierce County, Georgia",4455,2269,2186
GA,13,231,"Pike County, Georgia",2132,1008,1124
GA,13,233,"Polk County, Georgia",8767,3831,4936
GA,13,235,"Pulaski County, Georgia",1929,655,1274
GA,13,237,"Putnam County, Georgia",3446,1912,1534
GA,13,239,"Quitman County, Georgia",558,208,350
GA,13,241,"Rabun County, Georgia",3458,1544,1914
GA,13,243,"Randolph County, Georgia",2145,1079,1066
GA,13,245,"Richmond County, Georgia",48498,20943,27555
GA,13,247,"Rockdale County, Georgia",14155,6535,7620
GA,13,249,"Schley County, Georgia",1187,512,675
GA,13,251,"Screven County, Georgia",3482,1551,1931
GA,13,253,"Seminole County, Georgia",1595,594,1001
GA,13,255,"Spalding County, Georgia",14238,5975,8263
GA,13,257,"Stephens County, Georgia",4707,2468,2239
GA,13,259,"Stewart County, Georgia",1645,693,952
GA,13,261,"Sumter County, Georgia",9741,4124,5617
GA,13,263,"Talbot County, Georgia",1291,630,661
GA,13,265,"Taliaferro County, Georgia",511,195,316
GA,13,267,"Tattnall County, Georgia",5646,2173,3473
GA,13,269,"Taylor County, Georgia",2351,1041,1310
GA,13,271,"Telfair County, Georgia",3565,1401,2164
GA,13,273,"Terrell County, Georgia",3216,1329,1887
GA,13,275,"Thomas County, Georgia",10335,4943,5392
GA,13,277,"Tift County, Georgia",11372,4841,6531
GA,13,279,"Toombs County, Georgia",6674,2769,3905
GA,13,281,"Towns County, Georgia",1862,817,1045
GA,13,283,"Treutlen County, Georgia",1242,491,751
GA,13,285,"Troup County, Georgia",14388,5631,8757
GA,13,287,"Turner County, Georgia",2027,1067,960
GA,13,289,"Twiggs County, Georgia",2324,976,1348
GA,13,291,"Union County, Georgia",2860,1353,1507
GA,13,293,"Upson County, Georgia",6137,2988,3149
GA,13,295,"Walker County, Georgia",11818,5435,6383
GA,13,297,"Walton County, Georgia",11801,4642,7159
GA,13,299,"Ware County, Georgia",9686,3807,5879
GA,13,301,"Warren County, Georgia",1485,619,866
GA,13,303,"Washington County, Georgia",4961,2052,2909
GA,13,305,"Wayne County, Georgia",5633,2316,3317
GA,13,307,"Webster County, Georgia",608,222,386
GA,13,309,"Wheeler County, Georgia",1177,404,773
GA,13,311,"White County, Georgia",5195,2364,2831
GA,13,313,"Whitfield County, Georgia",19270,8532,10738
GA,13,315,"Wilcox County, Georgia",1599,675,924
GA,13,317,"Wilkes County, Georgia",2795,1122,1673
GA,13,319,"Wilkinson County, Georgia",1640,661,979
GA,13,321,"Worth County, Georgia",4445,1961,2484
HI,15,001,"Hawaii County, Hawaii",36756,17957,18799
HI,15,003,"Honolulu County, Hawaii",92404,41559,50845
HI,15,005,"Kalawao County, Hawaii",12,5,7
HI,15,007,"Kauai County, Hawaii",7384,3291,4093
HI,15,009,"Maui County, Hawaii",17388,7899,9489
IA,19,001,"Adair County, Iowa",764,274,490
IA,19,003,"Adams County, Iowa",388,177,211
IA,19,005,"Allamakee County, Iowa",1491,620,871
IA,19,007,"Appanoose County, Iowa",1719,749,970
IA,19,009,"Audubon County, Iowa",552,204,348
IA,19,011,"Benton County, Iowa",2440,1215,1225
IA,19,013,"Black Hawk County, Iowa",19887,8889,10998
IA,19,015,"Boone County, Iowa",2588,1093,1495
IA,19,017,"Bremer County, Iowa",1894,671,1223
IA,19,019,"Buchanan County, Iowa",1970,843,1127
IA,19,021,"Buena Vista County, Iowa",2452,1068,1384
IA,19,023,"Butler County, Iowa",1322,533,789
IA,19,025,"Calhoun County, Iowa",1384,658,726
IA,19,027,"Carroll County, Iowa",2047,675,1372
IA,19,029,"Cass County, Iowa",1855,888,967
IA,19,031,"Cedar County, Iowa",1393,615,778
IA,19,033,"Cerro Gordo County, Iowa",5665,2333,3332
IA,19,035,"Cherokee County, Iowa",1281,565,716
IA,19,037,"Chickasaw County, Iowa",1067,493,574
IA,19,039,"Clarke County, Iowa",1493,658,835
IA,19,041,"Clay County, Iowa",1848,727,1121
IA,19,043,"Clayton County, Iowa",1941,799,1142
IA,19,045,"Clinton County, Iowa",6608,2840,3768
IA,19,047,"Crawford County, Iowa",3367,1594,1773
IA,19,049,"Dallas County, Iowa",4796,2038,2758
IA,19,051,"Davis County, Iowa",1657,662,995
IA,19,053,"Decatur County, Iowa",1541,722,819
IA,19,055,"Delaware County, Iowa",1717,855,862
IA,19,057,"Des Moines County, Iowa",6010,2095,3915
IA,19,059,"Dickinson County, Iowa",1100,433,667
IA,19,061,"Dubuque County, Iowa",11189,4826,6363
IA,19,063,"Emmet County, Iowa",1250,524,726
IA,19,065,"Fayette County, Iowa",2550,1189,1361
IA,19,067,"Floyd County, Iowa",1957,836,1121
IA,19,069,"Franklin County, Iowa",1372,651,721
IA,19,071,"Fremont County, Iowa",757,372,385
IA,19,073,"Greene County, Iowa",1135,460,675
IA,19,075,"Grundy County, Iowa",757,288,469
IA,19,077,"Guthrie County, Iowa",1199,515,684
IA,19,079,"Hamilton County, Iowa",1712,700,1012
IA,19,081,"Hancock County, Iowa",924,413,511
IA,19,083,"Hardin County, Iowa",1454,584,870
IA,19,085,"Harrison County, Iowa",1398,633,765
IA,19,087,"Henry County, Iowa",2695,1303,1392
IA,19,089,"Howard County, Iowa",1081,472,609
IA,19,091,"Humboldt County, Iowa",1155,447,708
IA,19,093,"Ida County, Iowa",809,395,414
IA,19,095,"Iowa County, Iowa",1391,615,776
IA,19,097,"Jackson County, Iowa",2343,899,1444
IA,19,099,"Jasper County, Iowa",3342,1456,1886
IA,19,101,"Jefferson County, Iowa",2311,1294,1017
IA,19,103,"Johnson County, Iowa",23537,11609,11928
IA,19,105,"Jones County, Iowa",1950,828,1122
IA,19,107,"Keokuk County, Iowa",1374,613,761
IA,19,109,"Kossuth County, Iowa",1357,532,825
IA,19,111,"Lee County, Iowa",5791,2606,3185
IA,19,113,"Linn County, Iowa",20747,9853,10894
IA,19,115,"Louisa County, Iowa",1357,589,768
IA,19,117,"Lucas County, Iowa",1126,596,530
IA,19,119,"Lyon County, Iowa",843,404,439
IA,19,121,"Madison County, Iowa",1164,567,597
IA,19,123,"Mahaska County, Iowa",3206,1330,1876
IA,19,125,"Marion County, Iowa",3124,1459,1665
IA,19,127,"Marshall County, Iowa",4429,2268,2161
IA,19,129,"Mills County, Iowa",1300,667,633
IA,19,131,"Mitchell County, Iowa",1005,476,529
IA,19,133,"Monona County, Iowa",1233,529,704
IA,19,135,"Monroe County, Iowa",944,348,596
IA,19,137,"Montgomery County, Iowa",1717,715,1002
IA,19,139,"Muscatine County, Iowa",5219,2406,2813
IA,19,141,"O'Brien County, Iowa",1013,473,540
IA,19,143,"Osceola County, Iowa",521,192,329
IA,19,145,"Page County, Iowa",2262,1116,1146
IA,19,147,"Palo Alto County, Iowa",948,421,527
IA,19,149,"Plymouth County, Iowa",1907,817,1090
IA,19,151,"Pocahontas County, Iowa",987,458,529
IA,19,153,"Polk County, Iowa",57143,25452,31691
IA,19,155,"Pottawattamie County, Iowa",11779,5050,6729
IA,19,157,"Poweshiek County, Iowa",1767,731,1036
IA,19,159,"Ringgold County, Iowa",514,206,308
IA,19,161,"Sac County, Iowa",805,304,501
IA,19,163,"Scott County, Iowa",20229,8767,11462
IA,19,165,"Shelby County, Iowa",1307,600,707
IA,19,167,"Sioux County, Iowa",2663,1099,1564
IA,19,169,"Story County, Iowa",19109,10045,9064
IA,19,171,"Tama County, Iowa",1919,903,1016
IA,19,173,"Taylor County, Iowa",860,386,474
IA,19,175,"Union County, Iowa",1676,669,1007
IA,19,177,"Van Buren County, Iowa",1095,545,550
IA,19,179,"Wapello County, Iowa",6399,3090,3309
IA,19,181,"Warren County, Iowa",3124,1413,1711
IA,19,183,"Washington County, Iowa",2013,883,1130
IA,19,185,"Wayne County, Iowa",834,372,462
IA,19,187,"Webster County, Iowa",5210,2122,3088
IA,19,189,"Winnebago County, Iowa",995,465,530
IA,19,191,"Winneshiek County, Iowa",1507,676,831
IA,19,193,"Woodbury County, Iowa",14557,6122,8435
IA,19,195,"Worth County, Iowa",887,389,498
IA,19,197,"Wright County, Iowa",1412,649,763
ID,16,001,"Ada County, Idaho",50551,24218,26333
ID,16,003,"Adams County, Idaho",495,261,234
ID,16,005,"Bannock County, Idaho",15288,7053,8235
ID,16,007,"Bear Lake County, Idaho",759,352,407
ID,16,009,"Benewah County, Idaho",1490,695,795
ID,16,011,"Bingham County, Idaho",6093,2801,3292
ID,16,013,"Blaine County, Idaho",2218,989,1229
ID,16,015,"Boise County, Idaho",991,490,501
ID,16,017,"Bonner County, Idaho",6145,2946,3199
ID,16,019,"Bonneville County, Idaho",14025,6101,7924
ID,16,021,"Boundary County, Idaho",1647,774,873
ID,16,023,"Butte County, Idaho",460,241,219
ID,16,025,"Camas County, Idaho",229,101,128
ID,16,027,"Canyon County, Idaho",37945,17283,20662
ID,16,029,"Caribou County, Idaho",551,215,336
ID,16,031,"Cassia County, Idaho",3645,1616,2029
ID,16,033,"Clark County, Idaho",163,98,65
ID,16,035,"Clearwater County, Idaho",985,423,562
ID,16,037,"Custer County, Idaho",806,397,409
ID,16,039,"Elmore County, Idaho",4046,1773,2273
ID,16,041,"Franklin County, Idaho",1696,773,923
ID,16,043,"Fremont County, Idaho",1266,601,665
ID,16,045,"Gem County, Idaho",2980,1404,1576
ID,16,047,"Gooding County, Idaho",2911,1593,1318
ID,16,049,"Idaho County, Idaho",2528,1219,1309
ID,16,051,"Jefferson County, Idaho",3492,1558,1934
ID,16,053,"Jerome County, Idaho",3676,1577,2099
ID,16,055,"Kootenai County, Idaho",18634,8293,10341
ID,16,057,"Latah County, Idaho",7597,3909,3688
ID,16,059,"Lemhi County, Idaho",1430,657,773
ID,16,061,"Lewis County, Idaho",652,251,401
ID,16,063,"Lincoln County, Idaho",709,341,368
ID,16,065,"Madison County, Idaho",13232,6357,6875
ID,16,067,"Minidoka County, Idaho",3501,1562,1939
ID,16,069,"Nez Perce County, Idaho",4581,2166,2415
ID,16,071,"Oneida County, Idaho",615,292,323
ID,16,073,"Owyhee County, Idaho",3091,1580,1511
ID,16,075,"Payette County, Idaho",4152,1963,2189
ID,16,077,"Power County, Idaho",1034,353,681
ID,16,079,"Shoshone County, Idaho",2108,1006,1102
ID,16,081,"Teton County, Idaho",1110,441,669
ID,16,083,"Twin Falls County, Idaho",12418,5566,6852
ID,16,085,"Valley County, Idaho",1434,857,577
ID,16,087,"Washington County, Idaho",1798,886,912
IL,17,001,"Adams County, Illinois",9433,4259,5174
IL,17,003,"Alexander County, Illinois",2424,1018,1406
IL,17,005,"Bond County, Illinois",2593,1121,1472
IL,17,007,"Boone County, Illinois",5841,2237,3604
IL,17,009,"Brown County, Illinois",565,305,260
IL,17,011,"Bureau County, Illinois",4191,1800,2391
IL,17,013,"Calhoun County, Illinois",606,294,312
IL,17,015,"Carroll County, Illinois",1843,894,949
IL,17,017,"Cass County, Illinois",1688,775,913
IL,17,019,"Champaign County, Illinois",43284,21117,22167
IL,17,021,"Christian County, Illinois",4714,1953,2761
IL,17,023,"Clark County, Illinois",2360,995,1365
IL,17,025,"Clay County, Illinois",1839,719,1120
IL,17,027,"Clinton County, Illinois",3193,1251,1942
IL,17,029,"Coles County, Illinois",10951,4833,6118
IL,17,031,"Cook County, Illinois",879499,392713,486786
IL,17,033,"Crawford County, Illinois",2310,1127,1183
IL,17,035,"Cumberland County, Illinois",1700,755,945
IL,17,037,"DeKalb County, Illinois",18336,7881,10455
IL,17,039,"De Witt County, Illinois",2073,936,1137
IL,17,041,"Douglas County, Illinois",2019,829,1190
IL,17,043,"DuPage County, Illinois",67941,30099,37842
IL,17,045,"Edgar County, Illinois",2999,1370,1629
IL,17,047,"Edwards County, Illinois",851,364,487
IL,17,049,"Effingham County, Illinois",3557,1758,1799
IL,17,051,"Fayette County, Illinois",3644,1651,1993
IL,17,053,"Ford County, Illinois",1790,792,998
IL,17,055,"Franklin County, Illinois",7191,3279,3912
IL,17,057,"Fulton County, Illinois",4838,2193,2645
IL,17,059,"Gallatin County, Illinois",837,375,462
IL,17,061,"Greene County, Illinois",2231,994,1237
IL,17,063,"Grundy County, Illinois",4531,1897,2634
IL,17,065,"Hamilton County, Illinois",1211,565,646
IL,17,067,"Hancock County, Illinois",2159,950,1209
IL,17,069,"Hardin County, Illinois",864,355,509
IL,17,071,"Henderson County, Illinois",692,230,462
IL,17,073,"Henry County, Illinois",5256,2166,3090
IL,17,075,"Iroquois County, Illinois",4735,2010,2725
IL,17,077,"Jackson County, Illinois",16853,8533,8320
IL,17,079,"Jasper County, Illinois",881,319,562
IL,17,081,"Jefferson County, Illinois",6179,2740,3439
IL,17,083,"Jersey County, Illinois",1590,559,1031
IL,17,085,"Jo Daviess County, Illinois",2032,849,1183
IL,17,087,"Johnson County, Illinois",1589,761,828
IL,17,089,"Kane County, Illinois",59033,26663,32370
IL,17,091,"Kankakee County, Illinois",17365,7945,9420
IL,17,093,"Kendall County, Illinois",6616,2622,3994
IL,17,095,"Knox County, Illinois",9013,4050,4963
IL,17,097,"Lake County, Illinois",65728,30540,35188
IL,17,099,"LaSalle County, Illinois",14386,6252,8134
IL,17,101,"Lawrence County, Illinois",1509,549,960
IL,17,103,"Lee County, Illinois",3555,1680,1875
IL,17,105,"Livingston County, Illinois",3897,1699,2198
IL,17,107,"Logan County, Illinois",3303,1336,1967
IL,17,109,"McDonough County, Illinois",6394,2743,3651
IL,17,111,"McHenry County, Illinois",24037,11663,12374
IL,17,113,"McLean County, Illinois",23795,10918,12877
IL,17,115,"Macon County, Illinois",19411,8246,11165
IL,17,117,"Macoupin County, Illinois",5729,2375,3354
IL,17,119,"Madison County, Illinois",34818,15421,19397
IL,17,121,"Marion County, Illinois",6965,3100,3865
IL,17,123,"Marshall County, Illinois",1201,439,762
IL,17,125,"Mason County, Illinois",2095,919,1176
IL,17,127,"Massac County, Illinois",2705,1251,1454
IL,17,129,"Menard County, Illinois",1404,603,801
IL,17,131,"Mercer County, Illinois",1498,616,882
IL,17,133,"Monroe County, Illinois",1667,529,1138
IL,17,135,"Montgomery County, Illinois",3503,1170,2333
IL,17,137,"Morgan County, Illinois",4580,2222,2358
IL,17,139,"Moultrie County, Illinois",1929,1000,929
IL,17,141,"Ogle County, Illinois",5477,2460,3017
IL,17,143,"Peoria County, Illinois",31194,13602,17592
IL,17,145,"Perry County, Illinois",3380,1383,1997
IL,17,147,"Piatt County, Illinois",1019,398,621
IL,17,149,"Pike County, Illinois",2133,1011,1122
IL,17,151,"Pope County, Illinois",615,247,368
IL,17,153,"Pulaski County, Illinois",1178,529,649
IL,17,155,"Putnam County, Illinois",691,304,387
IL,17,157,"Randolph County, Illinois",3816,1716,2100
IL,17,159,"Richland County, Illinois",2382,1001,1381
IL,17,161,"Rock Island County, Illinois",21223,9137,12086
IL,17,163,"St. Clair County, Illinois",47946,20261,27685
IL,17,165,"Saline County, Illinois",5534,2362,3172
IL,17,167,"Sangamon County, Illinois",30297,13769,16528
IL,17,169,"Schuyler County, Illinois",1382,885,497
IL,17,171,"Scott County, Illinois",712,332,380
IL,17,173,"Shelby County, Illinois",2449,1159,1290
IL,17,175,"Stark County, Illinois",684,271,413
IL,17,177,"Stephenson County, Illinois",6849,2985,3864
IL,17,179,"Tazewell County, Illinois",11559,4787,6772
IL,17,181,"Union County, Illinois",2971,1495,1476
IL,17,183,"Vermilion County, Illinois",14571,6430,8141
IL,17,185,"Wabash County, Illinois",1447,617,830
IL,17,187,"Warren County, Illinois",2464,992,1472
IL,17,189,"Washington County, Illinois",1834,861,973
IL,17,191,"Wayne County, Illinois",2385,1052,1333
IL,17,193,"White County, Illinois",1916,825,1091
IL,17,195,"Whiteside County, Illinois",6740,2999,3741
IL,17,197,"Will County, Illinois",53482,22781,30701
IL,17,199,"Williamson County, Illinois",9783,4284,5499
IL,17,201,"Winnebago County, Illinois",47851,21483,26368
IL,17,203,"Woodford County, Illinois",3105,1461,1644
IN,18,001,"Adams County, Indiana",5529,2596,2933
IN,18,003,"Allen County, Indiana",56542,25163,31379
IN,18,005,"Bartholomew County, Indiana",10027,4645,5382
IN,18,007,"Benton County, Indiana",1181,512,669
IN,18,009,"Blackford County, Indiana",1700,664,1036
IN,18,011,"Boone County, Indiana",3498,1551,1947
IN,18,013,"Brown County, Indiana",1865,959,906
IN,18,015,"Carroll County, Indiana",2149,895,1254
IN,18,017,"Cass County, Indiana",5884,2717,3167
IN,18,019,"Clark County, Indiana",12009,5616,6393
IN,18,021,"Clay County, Indiana",3807,1695,2112
IN,18,023,"Clinton County, Indiana",4504,2018,2486
IN,18,025,"Crawford County, Indiana",2166,975,1191
IN,18,027,"Daviess County, Indiana",4192,1934,2258
IN,18,029,"Dearborn County, Indiana",4553,1982,2571
IN,18,031,"Decatur County, Indiana",3647,1518,2129
IN,18,033,"DeKalb County, Indiana",6107,2741,3366
IN,18,035,"Delaware County, Indiana",24209,10795,13414
IN,18,037,"Dubois County, Indiana",4071,1772,2299
IN,18,039,"Elkhart County, Indiana",31601,12817,18784
IN,18,041,"Fayette County, Indiana",4806,2129,2677
IN,18,043,"Floyd County, Indiana",9530,4041,5489
IN,18,045,"Fountain County, Indiana",1992,870,1122
IN,18,047,"Franklin County, Indiana",2413,1094,1319
IN,18,049,"Fulton County, Indiana",3011,1441,1570
IN,18,051,"Gibson County, Indiana",3675,1611,2064
IN,18,053,"Grant County, Indiana",11829,5068,6761
IN,18,055,"Greene County, Indiana",4398,1869,2529
IN,18,057,"Hamilton County, Indiana",13889,5730,8159
IN,18,059,"Hancock County, Indiana",4583,1738,2845
IN,18,061,"Harrison County, Indiana",5392,2399,2993
IN,18,063,"Hendricks County, Indiana",7514,2643,4871
IN,18,065,"Henry County, Indiana",7465,3105,4360
IN,18,067,"Howard County, Indiana",14445,6520,7925
IN,18,069,"Huntington County, Indiana",4241,1829,2412
IN,18,071,"Jackson County, Indiana",6297,2608,3689
IN,18,073,"Jasper County, Indiana",2710,1252,1458
IN,18,075,"Jay County, Indiana",3400,1570,1830
IN,18,077,"Jefferson County, Indiana",4343,1949,2394
IN,18,079,"Jennings County, Indiana",4390,2189,2201
IN,18,081,"Johnson County, Indiana",14205,6368,7837
IN,18,083,"Knox County, Indiana",5630,2479,3151
IN,18,085,"Kosciusko County, Indiana",8645,3964,4681
IN,18,087,"LaGrange County, Indiana",4909,2157,2752
IN,18,089,"Lake County, Indiana",87203,37304,49899
IN,18,091,"LaPorte County, Indiana",17792,7191,10601
IN,18,093,"Lawrence County, Indiana",5850,2758,3092
IN,18,095,"Madison County, Indiana",21089,9753,11336
IN,18,097,"Marion County, Indiana",191309,86399,104910
IN,18,099,"Marshall County, Indiana",5594,2265,3329
IN,18,101,"Martin County, Indiana",1320,532,788
IN,18,103,"Miami County, Indiana",5174,2271,2903
IN,18,105,"Monroe County, Indiana",31707,15337,16370
IN,18,107,"Montgomery County, Indiana",5153,2408,2745
IN,18,109,"Morgan County, Indiana",8237,3406,4831
IN,18,111,"Newton County, Indiana",1892,703,1189
IN,18,113,"Noble County, Indiana",5665,2582,3083
IN,18,115,"Ohio County, Indiana",470,219,251
IN,18,117,"Orange County, Indiana",3403,1562,1841
IN,18,119,"Owen County, Indiana",3172,1535,1637
IN,18,121,"Parke County, Indiana",2486,1103,1383
IN,18,123,"Perry County, Indiana",2276,1020,1256
IN,18,125,"Pike County, Indiana",1243,579,664
IN,18,127,"Porter County, Indiana",18850,8093,10757
IN,18,129,"Posey County, Indiana",2801,1480,1321
IN,18,131,"Pulaski County, Indiana",1808,707,1101
IN,18,133,"Putnam County, Indiana",3245,1391,1854
IN,18,135,"Randolph County, Indiana",4522,1782,2740
IN,18,137,"Ripley County, Indiana",2403,1042,1361
IN,18,139,"Rush County, Indiana",2946,1189,1757
IN,18,141,"St. Joseph County, Indiana",45532,19992,25540
IN,18,143,"Scott County, Indiana",4148,1896,2252
IN,18,145,"Shelby County, Indiana",5302,2258,3044
IN,18,147,"Spencer County, Indiana",2213,906,1307
IN,18,149,"Starke County, Indiana",3682,1634,2048
IN,18,151,"Steuben County, Indiana",3542,1577,1965
IN,18,153,"Sullivan County, Indiana",3534,1469,2065
IN,18,155,"Switzerland County, Indiana",2022,1025,997
IN,18,157,"Tippecanoe County, Indiana",36902,18433,18469
IN,18,159,"Tipton County, Indiana",1529,732,797
IN,18,161,"Union County, Indiana",754,372,382
IN,18,163,"Vanderburgh County, Indiana",28870,12815,16055
IN,18,165,"Vermillion County, Indiana",1996,896,1100
IN,18,167,"Vigo County, Indiana",20245,9199,11046
IN,18,169,"Wabash County, Indiana",4373,1771,2602
IN,18,171,"Warren County, Indiana",740,297,443
IN,18,173,"Warrick County, Indiana",5926,2551,3375
IN,18,175,"Washington County, Indiana",4190,1900,2290
IN,18,177,"Wayne County, Indiana",13732,6012,7720
IN,18,179,"Wells County, Indiana",3306,1449,1857
IN,18,181,"White County, Indiana",2309,1029,1280
IN,18,183,"Whitley County, Indiana",2633,1208,1425
KS,20,001,"Allen County, Kansas",2257,957,1300
KS,20,003,"Anderson County, Kansas",1362,668,694
KS,20,005,"Atchison County, Kansas",2970,1310,1660
KS,20,007,"Barber County, Kansas",511,245,266
KS,20,009,"Barton County, Kansas",4261,1840,2421
KS,20,011,"Bourbon County, Kansas",2757,1175,1582
KS,20,013,"Brown County, Kansas",1598,669,929
KS,20,015,"Butler County, Kansas",6620,2830,3790
KS,20,017,"Chase County, Kansas",360,164,196
KS,20,019,"Chautauqua County, Kansas",579,261,318
KS,20,021,"Cherokee County, Kansas",3511,1673,1838
KS,20,023,"Cheyenne County, Kansas",214,93,121
KS,20,025,"Clark County, Kansas",311,128,183
KS,20,027,"Clay County, Kansas",942,368,574
KS,20,029,"Cloud County, Kansas",1202,623,579
KS,20,031,"Coffey County, Kansas",833,425,408
KS,20,033,"Comanche County, Kansas",140,40,100
KS,20,035,"Cowley County, Kansas",5971,2742,3229
KS,20,037,"Crawford County, Kansas",8219,4161,4058
KS,20,039,"Decatur County, Kansas",316,108,208
KS,20,041,"Dickinson County, Kansas",2005,735,1270
KS,20,043,"Doniphan County, Kansas",892,444,448
KS,20,045,"Douglas County, Kansas",20137,10447,9690
KS,20,047,"Edwards County, Kansas",335,161,174
KS,20,049,"Elk County, Kansas",483,241,242
KS,20,051,"Ellis County, Kansas",4353,2259,2094
KS,20,053,"Ellsworth County, Kansas",484,171,313
KS,20,055,"Finney County, Kansas",6222,2572,3650
KS,20,057,"Ford County, Kansas",6183,3303,2880
KS,20,059,"Franklin County, Kansas",3264,1515,1749
KS,20,061,"Geary County, Kansas",4463,1978,2485
KS,20,063,"Gove County, Kansas",219,119,100
KS,20,065,"Graham County, Kansas",287,85,202
KS,20,067,"Grant County, Kansas",795,368,427
KS,20,069,"Gray County, Kansas",597,252,345
KS,20,071,"Greeley County, Kansas",97,38,59
KS,20,073,"Greenwood County, Kansas",945,408,537
KS,20,075,"Hamilton County, Kansas",371,137,234
KS,20,077,"Harper County, Kansas",933,443,490
KS,20,079,"Harvey County, Kansas",4415,1785,2630
KS,20,081,"Haskell County, Kansas",562,269,293
KS,20,083,"Hodgeman County, Kansas",88,44,44
KS,20,085,"Jackson County, Kansas",1197,414,783
KS,20,087,"Jefferson County, Kansas",1394,592,802
KS,20,089,"Jewell County, Kansas",466,200,266
KS,20,091,"Johnson County, Kansas",34556,14939,19617
KS,20,093,"Kearny County, Kansas",412,196,216
KS,20,095,"Kingman County, Kansas",811,289,522
KS,20,097,"Kiowa County, Kansas",364,177,187
KS,20,099,"Labette County, Kansas",3651,1642,2009
KS,20,101,"Lane County, Kansas",149,45,104
KS,20,103,"Leavenworth County, Kansas",8223,3686,4537
KS,20,105,"Lincoln County, Kansas",333,139,194
KS,20,107,"Linn County, Kansas",1246,607,639
KS,20,109,"Logan County, Kansas",232,98,134
KS,20,111,"Lyon County, Kansas",6919,3172,3747
KS,20,113,"McPherson County, Kansas",1993,704,1289
KS,20,115,"Marion County, Kansas",1306,620,686
KS,20,117,"Marshall County, Kansas",1087,407,680
KS,20,119,"Meade County, Kansas",481,174,307
KS,20,121,"Miami County, Kansas",2949,1213,1736
KS,20,123,"Mitchell County, Kansas",626,227,399
KS,20,125,"Montgomery County, Kansas",6303,2948,3355
KS,20,127,"Morris County, Kansas",505,229,276
KS,20,129,"Morton County, Kansas",325,151,174
KS,20,131,"Nemaha County, Kansas",1129,473,656
KS,20,133,"Neosho County, Kansas",2961,1306,1655
KS,20,135,"Ness County, Kansas",354,217,137
KS,20,137,"Norton County, Kansas",398,166,232
KS,20,139,"Osage County, Kansas",1997,852,1145
KS,20,141,"Osborne County, Kansas",564,232,332
KS,20,143,"Ottawa County, Kansas",466,217,249
KS,20,145,"Pawnee County, Kansas",464,179,285
KS,20,147,"Phillips County, Kansas",494,207,287
KS,20,149,"Pottawatomie County, Kansas",1992,859,1133
KS,20,151,"Pratt County, Kansas",1144,511,633
KS,20,153,"Rawlins County, Kansas",250,108,142
KS,20,155,"Reno County, Kansas",7457,3277,4180
KS,20,157,"Republic County, Kansas",599,248,351
KS,20,159,"Rice County, Kansas",1365,641,724
KS,20,161,"Riley County, Kansas",14922,7227,7695
KS,20,163,"Rooks County, Kansas",723,367,356
KS,20,165,"Rush County, Kansas",292,123,169
KS,20,167,"Russell County, Kansas",885,442,443
KS,20,169,"Saline County, Kansas",8700,3648,5052
KS,20,171,"Scott County, Kansas",319,104,215
KS,20,173,"Sedgwick County, Kansas",75400,34214,41186
KS,20,175,"Seward County, Kansas",4350,1771,2579
KS,20,177,"Shawnee County, Kansas",26445,12850,13595
KS,20,179,"Sheridan County, Kansas",165,49,116
KS,20,181,"Sherman County, Kansas",1125,605,520
KS,20,183,"Smith County, Kansas",543,207,336
KS,20,185,"Stafford County, Kansas",675,351,324
KS,20,187,"Stanton County, Kansas",113,41,72
KS,20,189,"Stevens County, Kansas",1037,423,614
KS,20,191,"Sumner County, Kansas",2869,1134,1735
KS,20,193,"Thomas County, Kansas",733,337,396
KS,20,195,"Trego County, Kansas",119,54,65
KS,20,197,"Wabaunsee County, Kansas",404,149,255
KS,20,199,"Wallace County, Kansas",129,54,75
KS,20,201,"Washington County, Kansas",649,265,384
KS,20,203,"Wichita County, Kansas",214,122,92
KS,20,205,"Wilson County, Kansas",1639,813,826
KS,20,207,"Woodson County, Kansas",714,328,386
KS,20,209,"Wyandotte County, Kansas",37963,17111,20852
KY,21,001,"Adair County, Kentucky",3789,1677,2112
KY,21,003,"Allen County, Kentucky",3454,1622,1832
KY,21,005,"Anderson County, Kentucky",2223,1071,1152
KY,21,007,"Ballard County, Kentucky",1295,521,774
KY,21,009,"Barren County, Kentucky",8598,3891,4707
KY,21,011,"Bath County, Kentucky",3122,1519,1603
KY,21,013,"Bell County, Kentucky",10233,4422,5811
KY,21,015,"Boone County, Kentucky",10156,4171,5985
KY,21,017,"Bourbon County, Kentucky",3272,1367,1905
KY,21,019,"Boyd County, Kentucky",9500,3956,5544
KY,21,021,"Boyle County, Kentucky",4291,1972,2319
KY,21,023,"Bracken County, Kentucky",1544,695,849
KY,21,025,"Breathitt County, Kentucky",4366,2095,2271
KY,21,027,"Breckinridge County, Kentucky",3422,1525,1897
KY,21,029,"Bullitt County, Kentucky",7911,3531,4380
KY,21,031,"Butler County, Kentucky",3667,1636,2031
KY,21,033,"Caldwell County, Kentucky",2544,1119,1425
KY,21,035,"Calloway County, Kentucky",8015,3642,4373
KY,21,037,"Campbell County, Kentucky",12883,5671,7212
KY,21,039,"Carlisle County, Kentucky",970,388,582
KY,21,041,"Carroll County, Kentucky",2898,1409,1489
KY,21,043,"Carter County, Kentucky",4682,2153,2529
KY,21,045,"Casey County, Kentucky",3969,1878,2091
KY,21,047,"Christian County, Kentucky",13576,5438,8138
KY,21,049,"Clark County, Kentucky",5401,2194,3207
KY,21,051,"Clay County, Kentucky",7732,3730,4002
KY,21,053,"Clinton County, Kentucky",2435,1078,1357
KY,21,055,"Crittenden County, Kentucky",1974,950,1024
KY,21,057,"Cumberland County, Kentucky",1682,652,1030
KY,21,059,"Daviess County, Kentucky",14948,6723,8225
KY,21,061,"Edmonson County, Kentucky",2296,971,1325
KY,21,063,"Elliott County, Kentucky",2079,1023,1056
KY,21,065,"Estill County, Kentucky",4199,1957,2242
KY,21,067,"Fayette County, Kentucky",55900,26117,29783
KY,21,069,"Fleming County, Kentucky",2907,1232,1675
KY,21,071,"Floyd County, Kentucky",11441,5471,5970
KY,21,073,"Franklin County, Kentucky",6990,3195,3795
KY,21,075,"Fulton County, Kentucky",1641,763,878
KY,21,077,"Gallatin County, Kentucky",1294,589,705
KY,21,079,"Garrard County, Kentucky",3653,1729,1924
KY,21,081,"Grant County, Kentucky",4445,1914,2531
KY,21,083,"Graves County, Kentucky",6342,2715,3627
KY,21,085,"Grayson County, Kentucky",6119,2731,3388
KY,21,087,"Green County, Kentucky",2216,1047,1169
KY,21,089,"Greenup County, Kentucky",6355,2848,3507
KY,21,091,"Hancock County, Kentucky",1360,654,706
KY,21,093,"Hardin County, Kentucky",14886,5818,9068
KY,21,095,"Harlan County, Kentucky",8661,3763,4898
KY,21,097,"Harrison County, Kentucky",4069,1749,2320
KY,21,099,"Hart County, Kentucky",4507,2082,2425
KY,21,101,"Henderson County, Kentucky",8602,3810,4792
KY,21,103,"Henry County, Kentucky",2798,1226,1572
KY,21,105,"Hickman County, Kentucky",675,284,391
KY,21,107,"Hopkins County, Kentucky",7799,3301,4498
KY,21,109,"Jackson County, Kentucky",4163,1963,2200
KY,21,111,"Jefferson County, Kentucky",121683,54397,67286
KY,21,113,"Jessamine County, Kentucky",9190,4128,5062
KY,21,115,"Johnson County, Kentucky",5977,2721,3256
KY,21,117,"Kenton County, Kentucky",23432,10164,13268
KY,21,119,"Knott County, Kentucky",4308,1935,2373
KY,21,121,"Knox County, Kentucky",10093,4551,5542
KY,21,123,"Larue County, Kentucky",2460,1058,1402
KY,21,125,"Laurel County, Kentucky",13588,6216,7372
KY,21,127,"Lawrence County, Kentucky",3548,1619,1929
KY,21,129,"Lee County, Kentucky",2003,952,1051
KY,21,131,"Leslie County, Kentucky",3051,1360,1691
KY,21,133,"Letcher County, Kentucky",6614,3158,3456
KY,21,135,"Lewis County, Kentucky",4151,1885,2266
KY,21,137,"Lincoln County, Kentucky",6039,2656,3383
KY,21,139,"Livingston County, Kentucky",1362,518,844
KY,21,141,"Logan County, Kentucky",5103,2411,2692
KY,21,143,"Lyon County, Kentucky",1002,340,662
KY,21,145,"McCracken County, Kentucky",10763,4614,6149
KY,21,147,"McCreary County, Kentucky",6723,3259,3464
KY,21,149,"McLean County, Kentucky",1983,1026,957
KY,21,151,"Madison County, Kentucky",16792,7821,8971
KY,21,153,"Magoffin County, Kentucky",3672,1659,2013
KY,21,155,"Marion County, Kentucky",3784,1646,2138
KY,21,157,"Marshall County, Kentucky",3287,1524,1763
KY,21,159,"Martin County, Kentucky",3896,1753,2143
KY,21,161,"Mason County, Kentucky",3087,1549,1538
KY,21,163,"Meade County, Kentucky",4810,2187,2623
KY,21,165,"Menifee County, Kentucky",1851,917,934
KY,21,167,"Mercer County, Kentucky",3862,1709,2153
KY,21,169,"Metcalfe County, Kentucky",2158,932,1226
KY,21,171,"Monroe County, Kentucky",2937,1363,1574
KY,21,173,"Montgomery County, Kentucky",6956,3141,3815
KY,21,175,"Morgan County, Kentucky",3249,1464,1785
KY,21,177,"Muhlenberg County, Kentucky",6000,2750,3250
KY,21,179,"Nelson County, Kentucky",7072,3347,3725
KY,21,181,"Nicholas County, Kentucky",1624,754,870
KY,21,183,"Ohio County, Kentucky",5208,2466,2742
KY,21,185,"Oldham County, Kentucky",3503,1271,2232
KY,21,187,"Owen County, Kentucky",1780,810,970
KY,21,189,"Owsley County, Kentucky",1710,810,900
KY,21,191,"Pendleton County, Kentucky",2188,875,1313
KY,21,193,"Perry County, Kentucky",6894,2903,3991
KY,21,195,"Pike County, Kentucky",14256,6146,8110
KY,21,197,"Powell County, Kentucky",3392,1361,2031
KY,21,199,"Pulaski County, Kentucky",16497,7900,8597
KY,21,201,"Robertson County, Kentucky",473,215,258
KY,21,203,"Rockcastle County, Kentucky",4105,1907,2198
KY,21,205,"Rowan County, Kentucky",5410,2340,3070
KY,21,207,"Russell County, Kentucky",4475,2055,2420
KY,21,209,"Scott County, Kentucky",5332,2152,3180
KY,21,211,"Shelby County, Kentucky",5566,2671,2895
KY,21,213,"Simpson County, Kentucky",3473,1486,1987
KY,21,215,"Spencer County, Kentucky",1466,577,889
KY,21,217,"Taylor County, Kentucky",5658,2390,3268
KY,21,219,"Todd County, Kentucky",2277,927,1350
KY,21,221,"Trigg County, Kentucky",2500,1030,1470
KY,21,223,"Trimble County, Kentucky",1486,737,749
KY,21,225,"Union County, Kentucky",4091,2171,1920
KY,21,227,"Warren County, Kentucky",21047,9159,11888
KY,21,229,"Washington County, Kentucky",2034,969,1065
KY,21,231,"Wayne County, Kentucky",5477,2505,2972
KY,21,233,"Webster County, Kentucky",2296,1117,1179
KY,21,235,"Whitley County, Kentucky",8871,4030,4841
KY,21,237,"Wolfe County, Kentucky",3058,1537,1521
KY,21,239,"Woodford County, Kentucky",3259,1279,1980
LA,22,001,"Acadia Parish, Louisiana",12539,4702,7837
LA,22,003,"Allen Parish, Louisiana",3501,1568,1933
LA,22,005,"Ascension Parish, Louisiana",13447,5551,7896
LA,22,007,"Assumption Parish, Louisiana",3643,1673,1970
LA,22,009,"Avoyelles Parish, Louisiana",8750,3408,5342
LA,22,011,"Beauregard Parish, Louisiana",7137,3103,4034
LA,22,013,"Bienville Parish, Louisiana",3754,1397,2357
LA,22,015,"Bossier Parish, Louisiana",17303,7402,9901
LA,22,017,"Caddo Parish, Louisiana",53752,23393,30359
LA,22,019,"Calcasieu Parish, Louisiana",32864,13822,19042
LA,22,021,"Caldwell Parish, Louisiana",2053,876,1177
LA,22,023,"Cameron Parish, Louisiana",650,317,333
LA,22,025,"Catahoula Parish, Louisiana",1890,872,1018
LA,22,027,"Claiborne Parish, Louisiana",4058,2023,2035
LA,22,029,"Concordia Parish, Louisiana",5598,2400,3198
LA,22,031,"De Soto Parish, Louisiana",7059,3061,3998
LA,22,033,"East Baton Rouge Parish, Louisiana",85254,37081,48173
LA,22,035,"East Carroll Parish, Louisiana",2903,1374,1529
LA,22,037,"East Feliciana Parish, Louisiana",3317,1569,1748
LA,22,039,"Evangeline Parish, Louisiana",8373,3718,4655
LA,22,041,"Franklin Parish, Louisiana",5847,2294,3553
LA,22,043,"Grant Parish, Louisiana",3460,1459,2001
LA,22,045,"Iberia Parish, Louisiana",14277,6094,8183
LA,22,047,"Iberville Parish, Louisiana",5612,2473,3139
LA,22,049,"Jackson Parish, Louisiana",3981,1799,2182
LA,22,051,"Jefferson Parish, Louisiana",72319,30773,41546
LA,22,053,"Jefferson Davis Parish, Louisiana",6462,2713,3749
LA,22,055,"Lafayette Parish, Louisiana",36346,15225,21121
LA,22,057,"Lafourche Parish, Louisiana",14117,5730,8387
LA,22,059,"LaSalle Parish, Louisiana",2857,1184,1673
LA,22,061,"Lincoln Parish, Louisiana",14146,6360,7786
LA,22,063,"Livingston Parish, Louisiana",19086,7960,11126
LA,22,065,"Madison Parish, Louisiana",3962,1840,2122
LA,22,067,"Morehouse Parish, Louisiana",7432,3212,4220
LA,22,069,"Natchitoches Parish, Louisiana",11208,4921,6287
LA,22,071,"Orleans Parish, Louisiana",98823,42998,55825
LA,22,073,"Ouachita Parish, Louisiana",36312,14458,21854
LA,22,075,"Plaquemines Parish, Louisiana",3775,1348,2427
LA,22,077,"Pointe Coupee Parish, Louisiana",4368,1876,2492
LA,22,079,"Rapides Parish, Louisiana",26645,11724,14921
LA,22,081,"Red River Parish, Louisiana",1937,803,1134
LA,22,083,"Richland Parish, Louisiana",4154,1825,2329
LA,22,085,"Sabine Parish, Louisiana",4626,1836,2790
LA,22,087,"St. Bernard Parish, Louisiana",8209,3529,4680
LA,22,089,"St. Charles Parish, Louisiana",6152,2412,3740
LA,22,091,"St. Helena Parish, Louisiana",2854,1309,1545
LA,22,093,"St. James Parish, Louisiana",3841,1845,1996
LA,22,095,"St. John the Baptist Parish, Louisiana",7893,3390,4503
LA,22,097,"St. Landry Parish, Louisiana",22970,9790,13180
LA,22,099,"St. Martin Parish, Louisiana",9388,3920,5468
LA,22,101,"St. Mary Parish, Louisiana",11746,4967,6779
LA,22,103,"St. Tammany Parish, Louisiana",27482,11568,15914
LA,22,105,"Tangipahoa Parish, Louisiana",26962,11734,15228
LA,22,107,"Tensas Parish, Louisiana",1685,731,954
LA,22,109,"Terrebonne Parish, Louisiana",21627,9182,12445
LA,22,111,"Union Parish, Louisiana",6166,2682,3484
LA,22,113,"Vermilion Parish, Louisiana",10379,4185,6194
LA,22,115,"Vernon Parish, Louisiana",7403,3280,4123
LA,22,117,"Washington Parish, Louisiana",11811,5364,6447
LA,22,119,"Webster Parish, Louisiana",9327,4117,5210
LA,22,121,"West Baton Rouge Parish, Louisiana",4662,1883,2779
LA,22,123,"West Carroll Parish, Louisiana",2746,1066,1680
LA,22,125,"West Feliciana Parish, Louisiana",1914,1016,898
LA,22,127,"Winn Parish, Louisiana",3466,1506,1960
MA,25,001,"Barnstable County, Massachusetts",18392,8191,10201
MA,25,003,"Berkshire County, Massachusetts",16038,6834,9204
MA,25,005,"Bristol County, Massachusetts",68016,29385,38631
MA,25,007,"Dukes County, Massachusetts",1970,802,1168
MA,25,009,"Essex County, Massachusetts",85417,35457,49960
MA,25,011,"Franklin County, Massachusetts",8210,3508,4702
MA,25,013,"Hampden County, Massachusetts",79308,34517,44791
MA,25,015,"Hampshire County, Massachusetts",20317,9564,10753
MA,25,017,"Middlesex County, Massachusetts",124958,53601,71357
MA,25,019,"Nantucket County, Massachusetts",1205,657,548
MA,25,021,"Norfolk County, Massachusetts",44199,17778,26421
MA,25,023,"Plymouth County, Massachusetts",40309,17589,22720
MA,25,025,"Suffolk County, Massachusetts",148278,64005,84273
MA,25,027,"Worcester County, Massachusetts",92288,40222,52066
MD,24,001,"Allegany County, Maryland",11927,5722,6205
MD,24,003,"Anne Arundel County, Maryland",31573,13598,17975
MD,24,005,"Baltimore County, Maryland",75464,30881,44583
MD,24,009,"Calvert County, Maryland",5207,2044,3163
MD,24,011,"Caroline County, Maryland",5086,2254,2832
MD,24,013,"Carroll County, Maryland",9205,4085,5120
MD,24,015,"Cecil County, Maryland",10179,4664,5515
MD,24,017,"Charles County, Maryland",11905,4933,6972
MD,24,019,"Dorchester County, Maryland",5275,2146,3129
MD,24,021,"Frederick County, Maryland",16204,7194,9010
MD,24,023,"Garrett County, Maryland",3615,1673,1942
MD,24,025,"Harford County, Maryland",19854,8342,11512
MD,24,027,"Howard County, Maryland",15759,6684,9075
MD,24,029,"Kent County, Maryland",2051,825,1226
MD,24,031,"Montgomery County, Maryland",67820,28612,39208
MD,24,033,"Prince George's County, Maryland",84018,36085,47933
MD,24,035,"Queen Anne's County, Maryland",3588,1721,1867
MD,24,037,"St. Mary's County, Maryland",8384,3098,5286
MD,24,039,"Somerset County, Maryland",4681,1834,2847
MD,24,041,"Talbot County, Maryland",4202,1493,2709
MD,24,043,"Washington County, Maryland",18094,7436,10658
MD,24,045,"Wicomico County, Maryland",15493,6604,8889
MD,24,047,"Worcester County, Maryland",5567,2436,3131
MD,24,510,"Baltimore city, Maryland",141654,62133,79521
ME,23,001,"Androscoggin County, Maine",16332,7347,8985
ME,23,003,"Aroostook County, Maine",12608,5761,6847
ME,23,005,"Cumberland County, Maine",32339,15055,17284
ME,23,007,"Franklin County, Maine",4318,1971,2347
ME,23,009,"Hancock County, Maine",7196,3075,4121
ME,23,011,"Kennebec County, Maine",16256,7316,8940
ME,23,013,"Knox County, Maine",4304,2232,2072
ME,23,015,"Lincoln County, Maine",4073,1809,2264
ME,23,017,"Oxford County, Maine",9911,4357,5554
ME,23,019,"Penobscot County, Maine",24933,11157,13776
ME,23,021,"Piscataquis County, Maine",3520,1643,1877
ME,23,023,"Sagadahoc County, Maine",4200,1710,2490
ME,23,025,"Somerset County, Maine",8907,4162,4745
ME,23,027,"Waldo County, Maine",6243,2895,3348
ME,23,029,"Washington County, Maine",5946,2598,3348
ME,23,031,"York County, Maine",19192,7672,11520
MI,26,001,"Alcona County, Michigan",1575,709,866
MI,26,003,"Alger County, Michigan",1213,635,578
MI,26,005,"Allegan County, Michigan",14185,6447,7738
MI,26,007,"Alpena County, Michigan",4898,2193,2705
MI,26,009,"Antrim County, Michigan",3316,1451,1865
MI,26,011,"Arenac County, Michigan",3013,1512,1501
MI,26,013,"Baraga County, Michigan",992,423,569
MI,26,015,"Barry County, Michigan",6377,2907,3470
MI,26,017,"Bay County, Michigan",15804,7485,8319
MI,26,019,"Benzie County, Michigan",1989,936,1053
MI,26,021,"Berrien County, Michigan",26719,11545,15174
MI,26,023,"Branch County, Michigan",7310,3527,3783
MI,26,025,"Calhoun County, Michigan",22931,10265,12666
MI,26,027,"Cass County, Michigan",7576,3689,3887
MI,26,029,"Charlevoix County, Michigan",3181,1431,1750
MI,26,031,"Cheboygan County, Michigan",4595,2023,2572
MI,26,033,"Chippewa County, Michigan",6485,3312,3173
MI,26,035,"Clare County, Michigan",7895,3545,4350
MI,26,037,"Clinton County, Michigan",8933,4098,4835
MI,26,039,"Crawford County, Michigan",2073,977,1096
MI,26,041,"Delta County, Michigan",6227,2966,3261
MI,26,043,"Dickinson County, Michigan",3523,1489,2034
MI,26,045,"Eaton County, Michigan",11524,5064,6460
MI,26,047,"Emmet County, Michigan",3506,1504,2002
MI,26,049,"Genesee County, Michigan",85696,38849,46847
MI,26,051,"Gladwin County, Michigan",5211,2382,2829
MI,26,053,"Gogebic County, Michigan",2859,1339,1520
MI,26,055,"Grand Traverse County, Michigan",9575,4520,5055
MI,26,057,"Gratiot County, Michigan",6792,2868,3924
MI,26,059,"Hillsdale County, Michigan",8982,4302,4680
MI,26,061,"Houghton County, Michigan",7406,4283,3123
MI,26,063,"Huron County, Michigan",4486,2093,2393
MI,26,065,"Ingham County, Michigan",59468,27305,32163
MI,26,067,"Ionia County, Michigan",9084,4395,4689
MI,26,069,"Iosco County, Michigan",4395,2005,2390
MI,26,071,"Iron County, Michigan",1749,875,874
MI,26,073,"Isabella County, Michigan",19390,9228,10162
MI,26,075,"Jackson County, Michigan",25464,11251,14213
MI,26,077,"Kalamazoo County, Michigan",45473,20808,24665
MI,26,079,"Kalkaska County, Michigan",2875,1379,1496
MI,26,081,"Kent County, Michigan",93489,42845,50644
MI,26,083,"Keweenaw County, Michigan",336,169,167
MI,26,085,"Lake County, Michigan",3164,1509,1655
MI,26,087,"Lapeer County, Michigan",9152,4261,4891
MI,26,089,"Leelanau County, Michigan",2245,1099,1146
MI,26,091,"Lenawee County, Michigan",13427,6044,7383
MI,26,093,"Livingston County, Michigan",10895,4813,6082
MI,26,095,"Luce County, Michigan",1059,453,606
MI,26,097,"Mackinac County, Michigan",1730,818,912
MI,26,099,"Macomb County, Michigan",106546,46437,60109
MI,26,101,"Manistee County, Michigan",3918,1767,2151
MI,26,103,"Marquette County, Michigan",10689,4951,5738
MI,26,105,"Mason County, Michigan",4861,2242,2619
MI,26,107,"Mecosta County, Michigan",9338,4257,5081
MI,26,109,"Menominee County, Michigan",3774,1517,2257
MI,26,111,"Midland County, Michigan",10955,4988,5967
MI,26,113,"Missaukee County, Michigan",2490,1153,1337
MI,26,115,"Monroe County, Michigan",16860,7388,9472
MI,26,117,"Montcalm County, Michigan",10924,4760,6164
MI,26,119,"Montmorency County, Michigan",1568,611,957
MI,26,121,"Muskegon County, Michigan",31550,14092,17458
MI,26,123,"Newaygo County, Michigan",8605,3978,4627
MI,26,125,"Oakland County, Michigan",123086,54727,68359
MI,26,127,"Oceana County, Michigan",5285,2524,2761
MI,26,129,"Ogemaw County, Michigan",4537,2019,2518
MI,26,131,"Ontonagon County, Michigan",967,464,503
MI,26,133,"Osceola County, Michigan",5032,2248,2784
MI,26,135,"Oscoda County, Michigan",1656,770,886
MI,26,137,"Otsego County, Michigan",3270,1318,1952
MI,26,139,"Ottawa County, Michigan",27361,12381,14980
MI,26,141,"Presque Isle County, Michigan",1761,792,969
MI,26,143,"Roscommon County, Michigan",4885,2222,2663
MI,26,145,"Saginaw County, Michigan",34825,15792,19033
MI,26,147,"St. Clair County, Michigan",23128,10571,12557
MI,26,149,"St. Joseph County, Michigan",10319,4684,5635
MI,26,151,"Sanilac County, Michigan",6522,2816,3706
MI,26,153,"Schoolcraft County, Michigan",1735,831,904
MI,26,155,"Shiawassee County, Michigan",9790,4325,5465
MI,26,157,"Tuscola County, Michigan",8317,3963,4354
MI,26,159,"Van Buren County, Michigan",14029,6400,7629
MI,26,161,"Washtenaw County, Michigan",51965,25329,26636
MI,26,163,"Wayne County, Michigan",440449,200486,239963
MI,26,165,"Wexford County, Michigan",5631,2846,2785
MN,27,001,"Aitkin County, Minnesota",1937,960,977
MN,27,003,"Anoka County, Minnesota",25925,12012,13913
MN,27,005,"Becker County, Minnesota",4160,1754,2406
MN,27,007,"Beltrami County, Minnesota",8118,3825,4293
MN,27,009,"Benton County, Minnesota",5732,2314,3418
MN,27,011,"Big Stone County, Minnesota",719,260,459
MN,27,013,"Blue Earth County, Minnesota",11745,5827,5918
MN,27,015,"Brown County, Minnesota",1887,931,956
MN,27,017,"Carlton County, Minnesota",4727,2502,2225
MN,27,019,"Carver County, Minnesota",4172,1886,2286
MN,27,021,"Cass County, Minnesota",4656,2195,2461
MN,27,023,"Chippewa County, Minnesota",1454,571,883
MN,27,025,"Chisago County, Minnesota",2889,1389,1500
MN,27,027,"Clay County, Minnesota",7202,3333,3869
MN,27,029,"Clearwater County, Minnesota",1451,704,747
MN,27,031,"Cook County, Minnesota",588,242,346
MN,27,033,"Cottonwood County, Minnesota",1905,862,1043
MN,27,035,"Crow Wing County, Minnesota",7028,3396,3632
MN,27,037,"Dakota County, Minnesota",31270,13735,17535
MN,27,039,"Dodge County, Minnesota",1342,575,767
MN,27,041,"Douglas County, Minnesota",3438,1671,1767
MN,27,043,"Faribault County, Minnesota",1878,814,1064
MN,27,045,"Fillmore County, Minnesota",2280,1062,1218
MN,27,047,"Freeborn County, Minnesota",3679,1371,2308
MN,27,049,"Goodhue County, Minnesota",5104,2254,2850
MN,27,051,"Grant County, Minnesota",533,209,324
MN,27,053,"Hennepin County, Minnesota",146382,68632,77750
MN,27,055,"Houston County, Minnesota",2031,1013,1018
MN,27,057,"Hubbard County, Minnesota",2368,1092,1276
MN,27,059,"Isanti County, Minnesota",2802,1404,1398
MN,27,061,"Itasca County, Minnesota",6018,2849,3169
MN,27,063,"Jackson County, Minnesota",1085,524,561
MN,27,065,"Kanabec County, Minnesota",2242,1011,1231
MN,27,067,"Kandiyohi County, Minnesota",4877,2120,2757
MN,27,069,"Kittson County, Minnesota",474,179,295
MN,27,071,"Koochiching County, Minnesota",1937,956,981
MN,27,073,"Lac qui Parle County, Minnesota",561,250,311
MN,27,075,"Lake County, Minnesota",1364,687,677
MN,27,077,"Lake of the Woods County, Minnesota",363,162,201
MN,27,079,"Le Sueur County, Minnesota",2482,1203,1279
MN,27,081,"Lincoln County, Minnesota",524,207,317
MN,27,083,"Lyon County, Minnesota",3456,1351,2105
MN,27,085,"McLeod County, Minnesota",2866,1279,1587
MN,27,087,"Mahnomen County, Minnesota",1350,638,712
MN,27,089,"Marshall County, Minnesota",734,286,448
MN,27,091,"Martin County, Minnesota",2286,870,1416
MN,27,093,"Meeker County, Minnesota",2282,951,1331
MN,27,095,"Mille Lacs County, Minnesota",3080,1382,1698
MN,27,097,"Morrison County, Minnesota",3687,1602,2085
MN,27,099,"Mower County, Minnesota",5410,2667,2743
MN,27,101,"Murray County, Minnesota",771,335,436
MN,27,103,"Nicollet County, Minnesota",3814,1884,1930
MN,27,105,"Nobles County, Minnesota",3320,1569,1751
MN,27,107,"Norman County, Minnesota",846,383,463
MN,27,109,"Olmsted County, Minnesota",13237,5835,7402
MN,27,111,"Otter Tail County, Minnesota",5635,2449,3186
MN,27,113,"Pennington County, Minnesota",1286,567,719
MN,27,115,"Pine County, Minnesota",4015,1890,2125
MN,27,117,"Pipestone County, Minnesota",1182,449,733
MN,27,119,"Polk County, Minnesota",3987,1987,2000
MN,27,121,"Pope County, Minnesota",1011,431,580
MN,27,123,"Ramsey County, Minnesota",84589,38727,45862
MN,27,125,"Red Lake County, Minnesota",431,206,225
MN,27,127,"Redwood County, Minnesota",1825,900,925
MN,27,129,"Renville County, Minnesota",1646,676,970
MN,27,131,"Rice County, Minnesota",6469,2720,3749
MN,27,133,"Rock County, Minnesota",1067,431,636
MN,27,135,"Roseau County, Minnesota",1637,749,888
MN,27,137,"St. Louis County, Minnesota",30869,14248,16621
MN,27,139,"Scott County, Minnesota",7747,3527,4220
MN,27,141,"Sherburne County, Minnesota",6966,2952,4014
MN,27,143,"Sibley County, Minnesota",1584,699,885
MN,27,145,"Stearns County, Minnesota",19570,9275,10295
MN,27,147,"Steele County, Minnesota",3721,1400,2321
MN,27,149,"Stevens County, Minnesota",1727,895,832
MN,27,151,"Swift County, Minnesota",1167,397,770
MN,27,153,"Todd County, Minnesota",3548,1677,1871
MN,27,155,"Traverse County, Minnesota",341,139,202
MN,27,157,"Wabasha County, Minnesota",1547,742,805
MN,27,159,"Wadena County, Minnesota",2211,979,1232
MN,27,161,"Waseca County, Minnesota",1544,752,792
MN,27,163,"Washington County, Minnesota",13109,5830,7279
MN,27,165,"Watonwan County, Minnesota",1182,351,831
MN,27,167,"Wilkin County, Minnesota",627,219,408
MN,27,169,"Winona County, Minnesota",6933,3476,3457
MN,27,171,"Wright County, Minnesota",7846,3355,4491
MN,27,173,"Yellow Medicine County, Minnesota",1175,588,587
MO,29,001,"Adair County, Missouri",6105,2917,3188
MO,29,003,"Andrew County, Missouri",1531,828,703
MO,29,005,"Atchison County, Missouri",693,298,395
MO,29,007,"Audrain County, Missouri",4401,2030,2371
MO,29,009,"Barry County, Missouri",7072,3303,3769
MO,29,011,"Barton County, Missouri",2910,1329,1581
MO,29,013,"Bates County, Missouri",2996,1355,1641
MO,29,015,"Benton County, Missouri",3540,1492,2048
MO,29,017,"Bollinger County, Missouri",2654,1198,1456
MO,29,019,"Boone County, Missouri",31824,14224,17600
MO,29,021,"Buchanan County, Missouri",15456,7270,8186
MO,29,023,"Butler County, Missouri",8942,3780,5162
MO,29,025,"Caldwell County, Missouri",1186,487,699
MO,29,027,"Callaway County, Missouri",5865,2577,3288
MO,29,029,"Camden County, Missouri",7516,3496,4020
MO,29,031,"Cape Girardeau County, Missouri",13626,6203,7423
MO,29,033,"Carroll County, Missouri",1273,555,718
MO,29,035,"Carter County, Missouri",1319,613,706
MO,29,037,"Cass County, Missouri",9805,3862,5943
MO,29,039,"Cedar County, Missouri",3381,1827,1554
MO,29,041,"Chariton County, Missouri",1213,572,641
MO,29,043,"Christian County, Missouri",8879,3800,5079
MO,29,045,"Clark County, Missouri",928,459,469
MO,29,047,"Clay County, Missouri",20137,9091,11046
MO,29,049,"Clinton County, Missouri",1856,763,1093
MO,29,051,"Cole County, Missouri",9237,4466,4771
MO,29,053,"Cooper County, Missouri",2354,1129,1225
MO,29,055,"Crawford County, Missouri",5093,2385,2708
MO,29,057,"Dade County, Missouri",1473,738,735
MO,29,059,"Dallas County, Missouri",3577,1685,1892
MO,29,061,"Daviess County, Missouri",1340,567,773
MO,29,063,"DeKalb County, Missouri",1391,636,755
MO,29,065,"Dent County, Missouri",3642,1575,2067
MO,29,067,"Douglas County, Missouri",2941,1441,1500
MO,29,069,"Dunklin County, Missouri",8536,3850,4686
MO,29,071,"Franklin County, Missouri",11941,5839,6102
MO,29,073,"Gasconade County, Missouri",2316,1157,1159
MO,29,075,"Gentry County, Missouri",1119,497,622
MO,29,077,"Greene County, Missouri",51533,22824,28709
MO,29,079,"Grundy County, Missouri",2020,900,1120
MO,29,081,"Harrison County, Missouri",1485,676,809
MO,29,083,"Henry County, Missouri",4131,1852,2279
MO,29,085,"Hickory County, Missouri",2394,992,1402
MO,29,087,"Holt County, Missouri",555,269,286
MO,29,089,"Howard County, Missouri",1587,768,819
MO,29,091,"Howell County, Missouri",9158,4270,4888
MO,29,093,"Iron County, Missouri",2293,1090,1203
MO,29,095,"Jackson County, Missouri",119678,53111,66567
MO,29,097,"Jasper County, Missouri",19556,8607,10949
MO,29,099,"Jefferson County, Missouri",23937,11024,12913
MO,29,101,"Johnson County, Missouri",8407,4131,4276
MO,29,103,"Knox County, Missouri",823,384,439
MO,29,105,"Laclede County, Missouri",6816,3199,3617
MO,29,107,"Lafayette County, Missouri",3706,1584,2122
MO,29,109,"Lawrence County, Missouri",7052,3252,3800
MO,29,111,"Lewis County, Missouri",1215,532,683
MO,29,113,"Lincoln County, Missouri",7980,3595,4385
MO,29,115,"Linn County, Missouri",2196,1008,1188
MO,29,117,"Livingston County, Missouri",2273,954,1319
MO,29,119,"McDonald County, Missouri",4876,2218,2658
MO,29,121,"Macon County, Missouri",2895,1311,1584
MO,29,123,"Madison County, Missouri",2238,888,1350
MO,29,125,"Maries County, Missouri",1721,883,838
MO,29,127,"Marion County, Missouri",5020,2181,2839
MO,29,129,"Mercer County, Missouri",584,269,315
MO,29,131,"Miller County, Missouri",4942,2218,2724
MO,29,133,"Mississippi County, Missouri",3642,1370,2272
MO,29,135,"Moniteau County, Missouri",1885,896,989
MO,29,137,"Monroe County, Missouri",1260,621,639
MO,29,139,"Montgomery County, Missouri",2025,923,1102
MO,29,141,"Morgan County, Missouri",4757,2515,2242
MO,29,143,"New Madrid County, Missouri",4094,1799,2295
MO,29,145,"Newton County, Missouri",8377,3814,4563
MO,29,147,"Nodaway County, Missouri",5682,2463,3219
MO,29,149,"Oregon County, Missouri",2824,1355,1469
MO,29,151,"Osage County, Missouri",1139,603,536
MO,29,153,"Ozark County, Missouri",2292,1023,1269
MO,29,155,"Pemiscot County, Missouri",5068,2070,2998
MO,29,157,"Perry County, Missouri",1798,765,1033
MO,29,159,"Pettis County, Missouri",7484,3292,4192
MO,29,161,"Phelps County, Missouri",8137,4289,3848
MO,29,163,"Pike County, Missouri",2482,1017,1465
MO,29,165,"Platte County, Missouri",7106,2824,4282
MO,29,167,"Polk County, Missouri",5515,2420,3095
MO,29,169,"Pulaski County, Missouri",5781,2598,3183
MO,29,171,"Putnam County, Missouri",926,444,482
MO,29,173,"Ralls County, Missouri",1254,511,743
MO,29,175,"Randolph County, Missouri",4395,1944,2451
MO,29,177,"Ray County, Missouri",3598,1755,1843
MO,29,179,"Reynolds County, Missouri",1361,658,703
MO,29,181,"Ripley County, Missouri",3167,1376,1791
MO,29,183,"St. Charles County, Missouri",23022,10046,12976
MO,29,185,"St. Clair County, Missouri",2156,1042,1114
MO,29,186,"Ste. Genevieve County, Missouri",2540,925,1615
MO,29,187,"St. Francois County, Missouri",11138,4933,6205
MO,29,189,"St. Louis County, Missouri",106821,44437,62384
MO,29,195,"Saline County, Missouri",3808,1786,2022
MO,29,197,"Schuyler County, Missouri",914,407,507
MO,29,199,"Scotland County, Missouri",730,279,451
MO,29,201,"Scott County, Missouri",7492,3283,4209
MO,29,203,"Shannon County, Missouri",1938,808,1130
MO,29,205,"Shelby County, Missouri",1092,466,626
MO,29,207,"Stoddard County, Missouri",4583,1898,2685
MO,29,209,"Stone County, Missouri",5147,2154,2993
MO,29,211,"Sullivan County, Missouri",1066,407,659
MO,29,213,"Taney County, Missouri",9825,4609,5216
MO,29,215,"Texas County, Missouri",5214,2506,2708
MO,29,217,"Vernon County, Missouri",3764,1645,2119
MO,29,219,"Warren County, Missouri",4507,2131,2376
MO,29,221,"Washington County, Missouri",5030,2223,2807
MO,29,223,"Wayne County, Missouri",2960,1342,1618
MO,29,225,"Webster County, Missouri",6733,3198,3535
MO,29,227,"Worth County, Missouri",294,127,167
MO,29,229,"Wright County, Missouri",4594,2173,2421
MO,29,510,"St. Louis city, Missouri",83416,37160,46256
MS,28,001,"Adams County, Mississippi",8898,3858,5040
MS,28,003,"Alcorn County, Mississippi",7752,3445,4307
MS,28,005,"Amite County, Mississippi",2852,1314,1538
MS,28,007,"Attala County, Mississippi",4908,1796,3112
MS,28,009,"Benton County, Mississippi",1764,886,878
MS,28,011,"Bolivar County, Mississippi",11900,5142,6758
MS,28,013,"Calhoun County, Mississippi",3763,1682,2081
MS,28,015,"Carroll County, Mississippi",2086,839,1247
MS,28,017,"Chickasaw County, Mississippi",4493,1854,2639
MS,28,019,"Choctaw County, Mississippi",2147,862,1285
MS,28,021,"Claiborne County, Mississippi",3685,1830,1855
MS,28,023,"Clarke County, Mississippi",3460,1429,2031
MS,28,025,"Clay County, Mississippi",5302,2240,3062
MS,28,027,"Coahoma County, Mississippi",8420,3418,5002
MS,28,029,"Copiah County, Mississippi",7629,3440,4189
MS,28,031,"Covington County, Mississippi",5162,2139,3023
MS,28,033,"DeSoto County, Mississippi",16338,6777,9561
MS,28,035,"Forrest County, Mississippi",20179,9239,10940
MS,28,037,"Franklin County, Mississippi",1464,703,761
MS,28,039,"George County, Mississippi",4154,1784,2370
MS,28,041,"Greene County, Mississippi",1566,553,1013
MS,28,043,"Grenada County, Mississippi",4733,2254,2479
MS,28,045,"Hancock County, Mississippi",9807,4704,5103
MS,28,047,"Harrison County, Mississippi",39569,17498,22071
MS,28,049,"Hinds County, Mississippi",61498,26487,35011
MS,28,051,"Holmes County, Mississippi",7860,3472,4388
MS,28,053,"Humphreys County, Mississippi",3508,1539,1969
MS,28,055,"Issaquena County, Mississippi",411,234,177
MS,28,057,"Itawamba County, Mississippi",4207,2133,2074
MS,28,059,"Jackson County, Mississippi",21400,9488,11912
MS,28,061,"Jasper County, Mississippi",3944,1645,2299
MS,28,063,"Jefferson County, Mississippi",3490,1504,1986
MS,28,065,"Jefferson Davis County, Mississippi",4028,1624,2404
MS,28,067,"Jones County, Mississippi",15197,6073,9124
MS,28,069,"Kemper County, Mississippi",2841,1127,1714
MS,28,071,"Lafayette County, Mississippi",11903,5486,6417
MS,28,073,"Lamar County, Mississippi",9748,4503,5245
MS,28,075,"Lauderdale County, Mississippi",17325,6745,10580
MS,28,077,"Lawrence County, Mississippi",2769,1275,1494
MS,28,079,"Leake County, Mississippi",6034,2548,3486
MS,28,081,"Lee County, Mississippi",15327,6413,8914
MS,28,083,"Leflore County, Mississippi",12558,5473,7085
MS,28,085,"Lincoln County, Mississippi",9091,3751,5340
MS,28,087,"Lowndes County, Mississippi",13675,5540,8135
MS,28,089,"Madison County, Mississippi",13287,5430,7857
MS,28,091,"Marion County, Mississippi",7156,3313,3843
MS,28,093,"Marshall County, Mississippi",6513,2947,3566
MS,28,095,"Monroe County, Mississippi",7123,2940,4183
MS,28,097,"Montgomery County, Mississippi",3058,1215,1843
MS,28,099,"Neshoba County, Mississippi",6957,3071,3886
MS,28,101,"Newton County, Mississippi",4737,1955,2782
MS,28,103,"Noxubee County, Mississippi",3953,1771,2182
MS,28,105,"Oktibbeha County, Mississippi",14780,7021,7759
MS,28,107,"Panola County, Mississippi",7793,3400,4393
MS,28,109,"Pearl River County, Mississippi",11590,4999,6591
MS,28,111,"Perry County, Mississippi",2287,865,1422
MS,28,113,"Pike County, Mississippi",11334,4633,6701
MS,28,115,"Pontotoc County, Mississippi",4903,2537,2366
MS,28,117,"Prentiss County, Mississippi",5112,2431,2681
MS,28,119,"Quitman County, Mississippi",2982,1280,1702
MS,28,121,"Rankin County, Mississippi",14067,5528,8539
MS,28,123,"Scott County, Mississippi",7743,3362,4381
MS,28,125,"Sharkey County, Mississippi",1380,607,773
MS,28,127,"Simpson County, Mississippi",6985,3372,3613
MS,28,129,"Smith County, Mississippi",3813,1606,2207
MS,28,131,"Stone County, Mississippi",3103,1626,1477
MS,28,133,"Sunflower County, Mississippi",8458,3444,5014
MS,28,135,"Tallahatchie County, Mississippi",2609,881,1728
MS,28,137,"Tate County, Mississippi",4656,2196,2460
MS,28,139,"Tippah County, Mississippi",5311,2352,2959
MS,28,141,"Tishomingo County, Mississippi",3146,1342,1804
MS,28,143,"Tunica County, Mississippi",2824,999,1825
MS,28,145,"Union County, Mississippi",6170,2262,3908
MS,28,147,"Walthall County, Mississippi",4199,1956,2243
MS,28,149,"Warren County, Mississippi",10768,4265,6503
MS,28,151,"Washington County, Mississippi",17586,7493,10093
MS,28,153,"Wayne County, Mississippi",5509,2334,3175
MS,28,155,"Webster County, Mississippi",2243,977,1266
MS,28,157,"Wilkinson County, Mississippi",2687,1182,1505
MS,28,159,"Winston County, Mississippi",5389,2222,3167
MS,28,161,"Yalobusha County, Mississippi",2472,1069,1403
MS,28,163,"Yazoo County, Mississippi",8017,3652,4365
MT,30,001,"Beaverhead County, Montana",1446,604,842
MT,30,003,"Big Horn County, Montana",3788,1737,2051
MT,30,005,"Blaine County, Montana",1795,839,956
MT,30,007,"Broadwater County, Montana",556,257,299
MT,30,009,"Carbon County, Montana",1137,505,632
MT,30,011,"Carter County, Montana",141,42,99
MT,30,013,"Cascade County, Montana",12212,5336,6876
MT,30,015,"Chouteau County, Montana",1341,610,731
MT,30,017,"Custer County, Montana",1298,566,732
MT,30,019,"Daniels County, Montana",100,30,70
MT,30,021,"Dawson County, Montana",1210,741,469
MT,30,023,"Deer Lodge County, Montana",1499,739,760
MT,30,025,"Fallon County, Montana",198,60,138
MT,30,027,"Fergus County, Montana",1287,592,695
MT,30,029,"Flathead County, Montana",12307,5818,6489
MT,30,031,"Gallatin County, Montana",12125,6297,5828
MT,30,033,"Garfield County, Montana",96,54,42
MT,30,035,"Glacier County, Montana",4447,1962,2485
MT,30,037,"Golden Valley County, Montana",201,91,110
MT,30,039,"Granite County, Montana",466,218,248
MT,30,041,"Hill County, Montana",3400,1581,1819
MT,30,043,"Jefferson County, Montana",1068,531,537
MT,30,045,"Judith Basin County, Montana",281,141,140
MT,30,047,"Lake County, Montana",6509,3171,3338
MT,30,049,"Lewis and Clark County, Montana",7803,3651,4152
MT,30,051,"Liberty County, Montana",416,174,242
MT,30,053,"Lincoln County, Montana",3554,1627,1927
MT,30,055,"McCone County, Montana",151,78,73
MT,30,057,"Madison County, Montana",820,408,412
MT,30,059,"Meagher County, Montana",265,77,188
MT,30,061,"Mineral County, Montana",721,331,390
MT,30,063,"Missoula County, Montana",17414,8279,9135
MT,30,065,"Musselshell County, Montana",774,324,450
MT,30,067,"Park County, Montana",1918,828,1090
MT,30,069,"Petroleum County, Montana",30,12,18
MT,30,071,"Phillips County, Montana",651,274,377
MT,30,073,"Pondera County, Montana",1283,676,607
MT,30,075,"Powder River County, Montana",155,71,84
MT,30,077,"Powell County, Montana",735,319,416
MT,30,079,"Prairie County, Montana",239,113,126
MT,30,081,"Ravalli County, Montana",7308,3338,3970
MT,30,083,"Richland County, Montana",1264,547,717
MT,30,085,"Roosevelt County, Montana",3007,1383,1624
MT,30,087,"Rosebud County, Montana",1893,826,1067
MT,30,089,"Sanders County, Montana",2497,1104,1393
MT,30,091,"Sheridan County, Montana",373,165,208
MT,30,093,"Silver Bow County, Montana",6771,3228,3543
MT,30,095,"Stillwater County, Montana",721,312,409
MT,30,097,"Sweet Grass County, Montana",458,203,255
MT,30,099,"Teton County, Montana",723,348,375
MT,30,101,"Toole County, Montana",866,341,525
MT,30,103,"Treasure County, Montana",178,104,74
MT,30,105,"Valley County, Montana",885,432,453
MT,30,107,"Wheatland County, Montana",410,194,216
MT,30,109,"Wibaux County, Montana",145,54,91
MT,30,111,"Yellowstone County, Montana",17250,7477,9773
NC,37,001,"Alamance County, North Carolina",29042,13130,15912
NC,37,003,"Alexander County, North Carolina",6191,3003,3188
NC,37,005,"Alleghany County, North Carolina",1986,852,1134
NC,37,007,"Anson County, North Carolina",5865,2550,3315
NC,37,009,"Ashe County, North Carolina",5510,2737,2773
NC,37,011,"Avery County, North Carolina",2350,1240,1110
NC,37,013,"Beaufort County, North Carolina",8660,3746,4914
NC,37,015,"Bertie County, North Carolina",4304,2038,2266
NC,37,017,"Bladen County, North Carolina",9342,4175,5167
NC,37,019,"Brunswick County, North Carolina",18725,8143,10582
NC,37,021,"Buncombe County, North Carolina",38256,17640,20616
NC,37,023,"Burke County, North Carolina",17277,7762,9515
NC,37,025,"Cabarrus County, North Carolina",23384,10512,12872
NC,37,027,"Caldwell County, North Carolina",15765,6956,8809
NC,37,029,"Camden County, North Carolina",803,370,433
NC,37,031,"Carteret County, North Carolina",10056,4547,5509
NC,37,033,"Caswell County, North Carolina",4634,2029,2605
NC,37,035,"Catawba County, North Carolina",23629,10699,12930
NC,37,037,"Chatham County, North Carolina",9041,4550,4491
NC,37,039,"Cherokee County, North Carolina",5319,2403,2916
NC,37,041,"Chowan County, North Carolina",3832,1747,2085
NC,37,043,"Clay County, North Carolina",2235,1007,1228
NC,37,045,"Cleveland County, North Carolina",19156,8012,11144
NC,37,047,"Columbus County, North Carolina",12768,5572,7196
NC,37,049,"Craven County, North Carolina",15664,6578,9086
NC,37,051,"Cumberland County, North Carolina",54949,22453,32496
NC,37,053,"Currituck County, North Carolina",2497,1018,1479
NC,37,055,"Dare County, North Carolina",2885,1204,1681
NC,37,057,"Davidson County, North Carolina",25655,11254,14401
NC,37,059,"Davie County, North Carolina",5210,2384,2826
NC,37,061,"Duplin County, North Carolina",15606,7197,8409
NC,37,063,"Durham County, North Carolina",49835,23570,26265
NC,37,065,"Edgecombe County, North Carolina",14210,6021,8189
NC,37,067,"Forsyth County, North Carolina",69100,30558,38542
NC,37,069,"Franklin County, North Carolina",9603,4247,5356
NC,37,071,"Gaston County, North Carolina",36027,15570,20457
NC,37,073,"Gates County, North Carolina",1651,683,968
NC,37,075,"Graham County, North Carolina",1884,867,1017
NC,37,077,"Granville County, North Carolina",8943,4172,4771
NC,37,079,"Greene County, North Carolina",4962,2049,2913
NC,37,081,"Guilford County, North Carolina",86808,37328,49480
NC,37,083,"Halifax County, North Carolina",13660,6086,7574
NC,37,085,"Harnett County, North Carolina",22094,9986,12108
NC,37,087,"Haywood County, North Carolina",10056,4642,5414
NC,37,089,"Henderson County, North Carolina",14984,7217,7767
NC,37,091,"Hertford County, North Carolina",5475,2134,3341
NC,37,093,"Hoke County, North Carolina",11047,4612,6435
NC,37,095,"Hyde County, North Carolina",890,278,612
NC,37,097,"Iredell County, North Carolina",22803,9533,13270
NC,37,099,"Jackson County, North Carolina",8139,3911,4228
NC,37,101,"Johnston County, North Carolina",27086,12599,14487
NC,37,103,"Jones County, North Carolina",2173,889,1284
NC,37,105,"Lee County, North Carolina",10533,4363,6170
NC,37,107,"Lenoir County, North Carolina",13401,5724,7677
NC,37,109,"Lincoln County, North Carolina",12243,5509,6734
NC,37,111,"McDowell County, North Carolina",8897,4138,4759
NC,37,113,"Macon County, North Carolina",6401,2951,3450
NC,37,115,"Madison County, North Carolina",3616,1490,2126
NC,37,117,"Martin County, North Carolina",5007,2191,2816
NC,37,119,"Mecklenburg County, North Carolina",148326,65072,83254
NC,37,121,"Mitchell County, North Carolina",2910,1265,1645
NC,37,123,"Montgomery County, North Carolina",6716,2942,3774
NC,37,125,"Moore County, North Carolina",13808,5800,8008
NC,37,127,"Nash County, North Carolina",17141,7079,10062
NC,37,129,"New Hanover County, North Carolina",36717,15886,20831
NC,37,131,"Northampton County, North Carolina",5658,2269,3389
NC,37,133,"Onslow County, North Carolina",24916,10709,14207
NC,37,135,"Orange County, North Carolina",20236,8668,11568
NC,37,137,"Pamlico County, North Carolina",1674,715,959
NC,37,139,"Pasquotank County, North Carolina",7256,2976,4280
NC,37,141,"Pender County, North Carolina",9925,4191,5734
NC,37,143,"Perquimans County, North Carolina",2626,1160,1466
NC,37,145,"Person County, North Carolina",7708,3574,4134
NC,37,147,"Pitt County, North Carolina",42743,18057,24686
NC,37,149,"Polk County, North Carolina",2790,1322,1468
NC,37,151,"Randolph County, North Carolina",24770,11758,13012
NC,37,153,"Richmond County, North Carolina",11465,5045,6420
NC,37,155,"Robeson County, North Carolina",41538,18723,22815
NC,37,157,"Rockingham County, North Carolina",16968,7168,9800
NC,37,159,"Rowan County, North Carolina",24194,10656,13538
NC,37,161,"Rutherford County, North Carolina",13077,5970,7107
NC,37,163,"Sampson County, North Carolina",16050,7577,8473
NC,37,165,"Scotland County, North Carolina",10504,4613,5891
NC,37,167,"Stanly County, North Carolina",10356,4702,5654
NC,37,169,"Stokes County, North Carolina",7826,3615,4211
NC,37,171,"Surry County, North Carolina",14195,6484,7711
NC,37,173,"Swain County, North Carolina",3409,1553,1856
NC,37,175,"Transylvania County, North Carolina",4017,1819,2198
NC,37,177,"Tyrrell County, North Carolina",779,326,453
NC,37,179,"Union County, North Carolina",21416,10081,11335
NC,37,181,"Vance County, North Carolina",11064,4926,6138
NC,37,183,"Wake County, North Carolina",107687,49166,58521
NC,37,185,"Warren County, North Carolina",4692,2290,2402
NC,37,187,"Washington County, North Carolina",2737,841,1896
NC,37,189,"Watauga County, North Carolina",14726,7773,6953
NC,37,191,"Wayne County, North Carolina",27037,11517,15520
NC,37,193,"Wilkes County, North Carolina",15791,7521,8270
NC,37,195,"Wilson County, North Carolina",18475,8116,10359
NC,37,197,"Yadkin County, North Carolina",7643,3528,4115
NC,37,199,"Yancey County, North Carolina",3775,1653,2122
ND,38,001,"Adams County, North Dakota",220,90,130
ND,38,003,"Barnes County, North Dakota",841,396,445
ND,38,005,"Benson County, North Dakota",2260,1070,1190
ND,38,007,"Billings County, North Dakota",100,49,51
ND,38,009,"Bottineau County, North Dakota",540,188,352
ND,38,011,"Bowman County, North Dakota",234,80,154
ND,38,013,"Burke County, North Dakota",301,124,177
ND,38,015,"Burleigh County, North Dakota",6946,3052,3894
ND,38,017,"Cass County, North Dakota",19082,8990,10092
ND,38,019,"Cavalier County, North Dakota",180,43,137
ND,38,021,"Dickey County, North Dakota",400,151,249
ND,38,023,"Divide County, North Dakota",178,72,106
ND,38,025,"Dunn County, North Dakota",517,246,271
ND,38,027,"Eddy County, North Dakota",311,166,145
ND,38,029,"Emmons County, North Dakota",386,166,220
ND,38,031,"Foster County, North Dakota",316,107,209
ND,38,033,"Golden Valley County, North Dakota",177,68,109
ND,38,035,"Grand Forks County, North Dakota",11223,5076,6147
ND,38,037,"Grant County, North Dakota",346,143,203
ND,38,039,"Griggs County, North Dakota",179,78,101
ND,38,041,"Hettinger County, North Dakota",217,70,147
ND,38,043,"Kidder County, North Dakota",185,86,99
ND,38,045,"LaMoure County, North Dakota",383,152,231
ND,38,047,"Logan County, North Dakota",151,62,89
ND,38,049,"McHenry County, North Dakota",738,333,405
ND,38,051,"McIntosh County, North Dakota",311,80,231
ND,38,053,"McKenzie County, North Dakota",1309,670,639
ND,38,055,"McLean County, North Dakota",1072,441,631
ND,38,057,"Mercer County, North Dakota",693,217,476
ND,38,059,"Morton County, North Dakota",2270,1079,1191
ND,38,061,"Mountrail County, North Dakota",1226,608,618
ND,38,063,"Nelson County, North Dakota",249,105,144
ND,38,065,"Oliver County, North Dakota",137,66,71
ND,38,067,"Pembina County, North Dakota",454,193,261
ND,38,069,"Pierce County, North Dakota",693,307,386
ND,38,071,"Ramsey County, North Dakota",1118,565,553
ND,38,073,"Ransom County, North Dakota",490,191,299
ND,38,075,"Renville County, North Dakota",186,85,101
ND,38,077,"Richland County, North Dakota",1633,659,974
ND,38,079,"Rolette County, North Dakota",5054,2207,2847
ND,38,081,"Sargent County, North Dakota",222,80,142
ND,38,083,"Sheridan County, North Dakota",209,65,144
ND,38,085,"Sioux County, North Dakota",1524,717,807
ND,38,087,"Slope County, North Dakota",68,33,35
ND,38,089,"Stark County, North Dakota",1866,755,1111
ND,38,091,"Steele County, North Dakota",143,74,69
ND,38,093,"Stutsman County, North Dakota",2130,854,1276
ND,38,095,"Towner County, North Dakota",316,126,190
ND,38,097,"Traill County, North Dakota",804,436,368
ND,38,099,"Walsh County, North Dakota",1112,464,648
ND,38,101,"Ward County, North Dakota",4919,1861,3058
ND,38,103,"Wells County, North Dakota",226,110,116
ND,38,105,"Williams County, North Dakota",2913,1402,1511
NE,31,001,"Adams County, Nebraska",3499,1490,2009
NE,31,003,"Antelope County, Nebraska",811,353,458
NE,31,005,"Arthur County, Nebraska",36,19,17
NE,31,007,"Banner County, Nebraska",96,30,66
NE,31,009,"Blaine County, Nebraska",106,61,45
NE,31,011,"Boone County, Nebraska",533,208,325
NE,31,013,"Box Butte County, Nebraska",1886,758,1128
NE,31,015,"Boyd County, Nebraska",220,97,123
NE,31,017,"Brown County, Nebraska",499,241,258
NE,31,019,"Buffalo County, Nebraska",5978,2737,3241
NE,31,021,"Burt County, Nebraska",620,265,355
NE,31,023,"Butler County, Nebraska",682,309,373
NE,31,025,"Cass County, Nebraska",1556,739,817
NE,31,027,"Cedar County, Nebraska",864,385,479
NE,31,029,"Chase County, Nebraska",337,161,176
NE,31,031,"Cherry County, Nebraska",648,175,473
NE,31,033,"Cheyenne County, Nebraska",1150,420,730
NE,31,035,"Clay County, Nebraska",580,233,347
NE,31,037,"Colfax County, Nebraska",1374,675,699
NE,31,039,"Cuming County, Nebraska",1071,376,695
NE,31,041,"Custer County, Nebraska",1200,526,674
NE,31,043,"Dakota County, Nebraska",3528,1510,2018
NE,31,045,"Dawes County, Nebraska",1428,531,897
NE,31,047,"Dawson County, Nebraska",3618,1439,2179
NE,31,049,"Deuel County, Nebraska",246,90,156
NE,31,051,"Dixon County, Nebraska",683,309,374
NE,31,053,"Dodge County, Nebraska",4061,1819,2242
NE,31,055,"Douglas County, Nebraska",76738,33674,43064
NE,31,057,"Dundy County, Nebraska",151,69,82
NE,31,059,"Fillmore County, Nebraska",514,167,347
NE,31,061,"Franklin County, Nebraska",396,183,213
NE,31,063,"Frontier County, Nebraska",305,113,192
NE,31,065,"Furnas County, Nebraska",820,337,483
NE,31,067,"Gage County, Nebraska",2080,925,1155
NE,31,069,"Garden County, Nebraska",181,81,100
NE,31,071,"Garfield County, Nebraska",193,63,130
NE,31,073,"Gosper County, Nebraska",110,44,66
NE,31,075,"Grant County, Nebraska",98,47,51
NE,31,077,"Greeley County, Nebraska",243,97,146
NE,31,079,"Hall County, Nebraska",9092,3927,5165
NE,31,081,"Hamilton County, Nebraska",780,303,477
NE,31,083,"Harlan County, Nebraska",450,215,235
NE,31,085,"Hayes County, Nebraska",68,36,32
NE,31,087,"Hitchcock County, Nebraska",490,237,253
NE,31,089,"Holt County, Nebraska",1209,512,697
NE,31,091,"Hooker County, Nebraska",123,71,52
NE,31,093,"Howard County, Nebraska",658,333,325
NE,31,095,"Jefferson County, Nebraska",909,361,548
NE,31,097,"Johnson County, Nebraska",471,214,257
NE,31,099,"Kearney County, Nebraska",408,181,227
NE,31,101,"Keith County, Nebraska",931,393,538
NE,31,103,"Keya Paha County, Nebraska",106,41,65
NE,31,105,"Kimball County, Nebraska",496,205,291
NE,31,107,"Knox County, Nebraska",1117,426,691
NE,31,109,"Lancaster County, Nebraska",41796,18624,23172
NE,31,111,"Lincoln County, Nebraska",4488,1775,2713
NE,31,113,"Logan County, Nebraska",91,33,58
NE,31,115,"Loup County, Nebraska",68,30,38
NE,31,117,"McPherson County, Nebraska",64,32,32
NE,31,119,"Madison County, Nebraska",5119,2075,3044
NE,31,121,"Merrick County, Nebraska",667,344,323
NE,31,123,"Morrill County, Nebraska",550,259,291
NE,31,125,"Nance County, Nebraska",490,253,237
NE,31,127,"Nemaha County, Nebraska",574,300,274
NE,31,129,"Nuckolls County, Nebraska",501,182,319
NE,31,131,"Otoe County, Nebraska",1696,740,956
NE,31,133,"Pawnee County, Nebraska",446,207,239
NE,31,135,"Perkins County, Nebraska",198,46,152
NE,31,137,"Phelps County, Nebraska",706,213,493
NE,31,139,"Pierce County, Nebraska",417,174,243
NE,31,141,"Platte County, Nebraska",2728,1336,1392
NE,31,143,"Polk County, Nebraska",389,184,205
NE,31,145,"Red Willow County, Nebraska",1118,572,546
NE,31,147,"Richardson County, Nebraska",1557,690,867
NE,31,149,"Rock County, Nebraska",162,48,114
NE,31,151,"Saline County, Nebraska",1492,705,787
NE,31,153,"Sarpy County, Nebraska",10684,4831,5853
NE,31,155,"Saunders County, Nebraska",2001,911,1090
NE,31,157,"Scotts Bluff County, Nebraska",4877,2163,2714
NE,31,159,"Seward County, Nebraska",1467,738,729
NE,31,161,"Sheridan County, Nebraska",857,426,431
NE,31,163,"Sherman County, Nebraska",411,126,285
NE,31,165,"Sioux County, Nebraska",156,64,92
NE,31,167,"Stanton County, Nebraska",701,298,403
NE,31,169,"Thayer County, Nebraska",604,298,306
NE,31,171,"Thomas County, Nebraska",55,24,31
NE,31,173,"Thurston County, Nebraska",2090,947,1143
NE,31,175,"Valley County, Nebraska",540,251,289
NE,31,177,"Washington County, Nebraska",1880,595,1285
NE,31,179,"Wayne County, Nebraska",1115,644,471
NE,31,181,"Webster County, Nebraska",459,235,224
NE,31,183,"Wheeler County, Nebraska",61,30,31
NE,31,185,"York County, Nebraska",1393,621,772
NH,33,001,"Belknap County, New Hampshire",6214,2893,3321
NH,33,003,"Carroll County, New Hampshire",4484,2015,2469
NH,33,005,"Cheshire County, New Hampshire",8467,3684,4783
NH,33,007,"Coos County, New Hampshire",4257,1950,2307
NH,33,009,"Grafton County, New Hampshire",9609,4252,5357
NH,33,011,"Hillsborough County, New Hampshire",34681,15707,18974
NH,33,013,"Merrimack County, New Hampshire",12840,5578,7262
NH,33,015,"Rockingham County, New Hampshire",16192,7315,8877
NH,33,017,"Strafford County, New Hampshire",12997,5717,7280
NH,33,019,"Sullivan County, New Hampshire",4099,1959,2140
NJ,34,001,"Atlantic County, New Jersey",40868,18753,22115
NJ,34,003,"Bergen County, New Jersey",67959,29262,38697
NJ,34,005,"Burlington County, New Jersey",27881,12238,15643
NJ,34,007,"Camden County, New Jersey",66802,28813,37989
NJ,34,009,"Cape May County, New Jersey",9744,4179,5565
NJ,34,011,"Cumberland County, New Jersey",25760,11633,14127
NJ,34,013,"Essex County, New Jersey",133788,57543,76245
NJ,34,015,"Gloucester County, New Jersey",23200,9915,13285
NJ,34,017,"Hudson County, New Jersey",114900,50273,64627
NJ,34,019,"Hunterdon County, New Jersey",5379,2236,3143
NJ,34,021,"Mercer County, New Jersey",40354,18218,22136
NJ,34,023,"Middlesex County, New Jersey",70908,31792,39116
NJ,34,025,"Monmouth County, New Jersey",46492,20092,26400
NJ,34,027,"Morris County, New Jersey",22068,9710,12358
NJ,34,029,"Ocean County, New Jersey",64795,29231,35564
NJ,34,031,"Passaic County, New Jersey",83203,37009,46194
NJ,34,033,"Salem County, New Jersey",8602,3826,4776
NJ,34,035,"Somerset County, New Jersey",16479,7340,9139
NJ,34,037,"Sussex County, New Jersey",8237,3862,4375
NJ,34,039,"Union County, New Jersey",59034,24322,34712
NJ,34,041,"Warren County, New Jersey",8394,3681,4713
NM,35,001,"Bernalillo County, New Mexico",128917,59967,68950
NM,35,003,"Catron County, New Mexico",615,177,438
NM,35,005,"Chaves County, New Mexico",14013,6312,7701
NM,35,006,"Cibola County, New Mexico",7489,3567,3922
NM,35,007,"Colfax County, New Mexico",2490,1121,1369
NM,35,009,"Curry County, New Mexico",10338,4527,5811
NM,35,011,"De Baca County, New Mexico",454,227,227
NM,35,013,"Doña Ana County, New Mexico",58846,27487,31359
NM,35,015,"Eddy County, New Mexico",6237,2460,3777
NM,35,017,"Grant County, New Mexico",5940,2771,3169
NM,35,019,"Guadalupe County, New Mexico",552,239,313
NM,35,021,"Harding County, New Mexico",59,29,30
NM,35,023,"Hidalgo County, New Mexico",1054,443,611
NM,35,025,"Lea County, New Mexico",9859,3934,5925
NM,35,027,"Lincoln County, New Mexico",3271,1479,1792
NM,35,028,"Los Alamos County, New Mexico",1092,429,663
NM,35,029,"Luna County, New Mexico",7236,3080,4156
NM,35,031,"McKinley County, New Mexico",27493,13235,14258
NM,35,033,"Mora County, New Mexico",1092,669,423
NM,35,035,"Otero County, New Mexico",14387,6638,7749
NM,35,037,"Quay County, New Mexico",1484,640,844
NM,35,039,"Rio Arriba County, New Mexico",9413,4770,4643
NM,35,041,"Roosevelt County, New Mexico",4918,2164,2754
NM,35,043,"Sandoval County, New Mexico",19305,8939,10366
NM,35,045,"San Juan County, New Mexico",24755,11972,12783
NM,35,047,"San Miguel County, New Mexico",8093,3544,4549
NM,35,049,"Santa Fe County, New Mexico",22477,10373,12104
NM,35,051,"Sierra County, New Mexico",2360,1347,1013
NM,35,053,"Socorro County, New Mexico",4278,1928,2350
NM,35,055,"Taos County, New Mexico",7909,3785,4124
NM,35,057,"Torrance County, New Mexico",4833,2325,2508
NM,35,059,"Union County, New Mexico",498,176,322
NM,35,061,"Valencia County, New Mexico",17604,8399,9205
NV,32,001,"Churchill County, Nevada",3802,1765,2037
NV,32,003,"Clark County, Nevada",315358,147575,167783
NV,32,005,"Douglas County, Nevada",4984,2264,2720
NV,32,007,"Elko County, Nevada",5574,2675,2899
NV,32,009,"Esmeralda County, Nevada",194,53,141
NV,32,011,"Eureka County, Nevada",162,106,56
NV,32,013,"Humboldt County, Nevada",1762,802,960
NV,32,015,"Lander County, Nevada",676,349,327
NV,32,017,"Lincoln County, Nevada",631,372,259
NV,32,019,"Lyon County, Nevada",8482,3749,4733
NV,32,021,"Mineral County, Nevada",907,429,478
NV,32,023,"Nye County, Nevada",7658,3541,4117
NV,32,027,"Pershing County, Nevada",832,350,482
NV,32,029,"Storey County, Nevada",293,134,159
NV,32,031,"Washoe County, Nevada",65248,30454,34794
NV,32,033,"White Pine County, Nevada",987,381,606
NV,32,510,"Carson City, Nevada",8787,3992,4795
NY,36,001,"Albany County, New York",39349,17368,21981
NY,36,003,"Allegany County, New York",7285,3424,3861
NY,36,005,"Bronx County, New York",427574,181112,246462
NY,36,007,"Broome County, New York",33615,15839,17776
NY,36,009,"Cattaraugus County, New York",13954,6444,7510
NY,36,011,"Cayuga County, New York",9010,4089,4921
NY,36,013,"Chautauqua County, New York",23894,10816,13078
NY,36,015,"Chemung County, New York",13044,5401,7643
NY,36,017,"Chenango County, New York",7741,3403,4338
NY,36,019,"Clinton County, New York",12163,5245,6918
NY,36,021,"Columbia County, New York",7067,3251,3816
NY,36,023,"Cortland County, New York",6675,2638,4037
NY,36,025,"Delaware County, New York",6799,3306,3493
NY,36,027,"Dutchess County, New York",26229,11831,14398
NY,36,029,"Erie County, New York",134715,59086,75629
NY,36,031,"Essex County, New York",3894,1756,2138
NY,36,033,"Franklin County, New York",9213,4383,4830
NY,36,035,"Fulton County, New York",9100,4176,4924
NY,36,037,"Genesee County, New York",7748,3521,4227
NY,36,039,"Greene County, New York",5813,2342,3471
NY,36,041,"Hamilton County, New York",609,317,292
NY,36,043,"Herkimer County, New York",9145,4089,5056
NY,36,045,"Jefferson County, New York",16938,7850,9088
NY,36,047,"Kings County, New York",597404,265335,332069
NY,36,049,"Lewis County, New York",3238,1478,1760
NY,36,051,"Livingston County, New York",8681,3775,4906
NY,36,053,"Madison County, New York",8180,3640,4540
NY,36,055,"Monroe County, New York",110192,48774,61418
NY,36,057,"Montgomery County, New York",10053,4433,5620
NY,36,059,"Nassau County, New York",82146,35207,46939
NY,36,061,"New York County, New York",283590,123922,159668
NY,36,063,"Niagara County, New York",28816,12569,16247
NY,36,065,"Oneida County, New York",37760,17386,20374
NY,36,067,"Onondaga County, New York",69487,31279,38208
NY,36,069,"Ontario County, New York",10975,4935,6040
NY,36,071,"Orange County, New York",46731,21428,25303
NY,36,073,"Orleans County, New York",6173,2836,3337
NY,36,075,"Oswego County, New York",21615,10192,11423
NY,36,077,"Otsego County, New York",9275,4372,4903
NY,36,079,"Putnam County, New York",5212,2693,2519
NY,36,081,"Queens County, New York",343834,148985,194849
NY,36,083,"Rensselaer County, New York",19186,8695,10491
NY,36,085,"Richmond County, New York",58470,26399,32071
NY,36,087,"Rockland County, New York",46118,21825,24293
NY,36,089,"St. Lawrence County, New York",19494,9391,10103
NY,36,091,"Saratoga County, New York",14583,6435,8148
NY,36,093,"Schenectady County, New York",19028,8584,10444
NY,36,095,"Schoharie County, New York",3936,1911,2025
NY,36,097,"Schuyler County, New York",2595,1062,1533
NY,36,099,"Seneca County, New York",4081,1817,2264
NY,36,101,"Steuben County, New York",15888,7157,8731
NY,36,103,"Suffolk County, New York",103269,45309,57960
NY,36,105,"Sullivan County, New York",12868,6015,6853
NY,36,107,"Tioga County, New York",4801,2062,2739
NY,36,109,"Tompkins County, New York",18547,8362,10185
NY,36,111,"Ulster County, New York",22290,10453,11837
NY,36,113,"Warren County, New York",7685,3218,4467
NY,36,115,"Washington County, New York",8004,3581,4423
NY,36,117,"Wayne County, New York",11541,5486,6055
NY,36,119,"Westchester County, New York",90752,39737,51015
NY,36,121,"Wyoming County, New York",4425,2081,2344
NY,36,123,"Yates County, New York",3446,1583,1863
OH,39,001,"Adams County, Ohio",6832,2970,3862
OH,39,003,"Allen County, Ohio",17713,8327,9386
OH,39,005,"Ashland County, Ohio",7569,3496,4073
OH,39,007,"Ashtabula County, Ohio",19266,8329,10937
OH,39,009,"Athens County, Ohio",18263,9227,9036
OH,39,011,"Auglaize County, Ohio",4010,1627,2383
OH,39,013,"Belmont County, Ohio",9553,4021,5532
OH,39,015,"Brown County, Ohio",6442,2678,3764
OH,39,017,"Butler County, Ohio",50312,21472,28840
OH,39,019,"Carroll County, Ohio",4317,1997,2320
OH,39,021,"Champaign County, Ohio",4756,2217,2539
OH,39,023,"Clark County, Ohio",24419,10932,13487
OH,39,025,"Clermont County, Ohio",21127,9318,11809
OH,39,027,"Clinton County, Ohio",6425,3000,3425
OH,39,029,"Columbiana County, Ohio",15730,6792,8938
OH,39,031,"Coshocton County, Ohio",5835,2516,3319
OH,39,033,"Crawford County, Ohio",6888,2976,3912
OH,39,035,"Cuyahoga County, Ohio",231823,101682,130141
OH,39,037,"Darke County, Ohio",6846,3045,3801
OH,39,039,"Defiance County, Ohio",5071,2187,2884
OH,39,041,"Delaware County, Ohio",8285,3705,4580
OH,39,043,"Erie County, Ohio",9333,4116,5217
OH,39,045,"Fairfield County, Ohio",15110,6752,8358
OH,39,047,"Fayette County, Ohio",5185,2461,2724
OH,39,049,"Franklin County, Ohio",208422,95908,112514
OH,39,051,"Fulton County, Ohio",4532,2197,2335
OH,39,053,"Gallia County, Ohio",6214,2541,3673
OH,39,055,"Geauga County, Ohio",6969,3258,3711
OH,39,057,"Greene County, Ohio",21065,9574,11491
OH,39,059,"Guernsey County, Ohio",7784,3427,4357
OH,39,061,"Hamilton County, Ohio",143778,63809,79969
OH,39,063,"Hancock County, Ohio",10221,4369,5852
OH,39,065,"Hardin County, Ohio",5491,2667,2824
OH,39,067,"Harrison County, Ohio",2657,1186,1471
OH,39,069,"Henry County, Ohio",3144,1325,1819
OH,39,071,"Highland County, Ohio",8604,3780,4824
OH,39,073,"Hocking County, Ohio",4894,2116,2778
OH,39,075,"Holmes County, Ohio",5398,2451,2947
OH,39,077,"Huron County, Ohio",7853,3501,4352
OH,39,079,"Jackson County, Ohio",7637,3320,4317
OH,39,081,"Jefferson County, Ohio",11533,4875,6658
OH,39,083,"Knox County, Ohio",8825,3995,4830
OH,39,085,"Lake County, Ohio",20063,8926,11137
OH,39,087,"Lawrence County, Ohio",11135,5080,6055
OH,39,089,"Licking County, Ohio",20926,9134,11792
OH,39,091,"Logan County, Ohio",6487,2767,3720
OH,39,093,"Lorain County, Ohio",42269,17426,24843
OH,39,095,"Lucas County, Ohio",90091,42034,48057
OH,39,097,"Madison County, Ohio",3580,1621,1959
OH,39,099,"Mahoning County, Ohio",40841,17922,22919
OH,39,101,"Marion County, Ohio",11127,4978,6149
OH,39,103,"Medina County, Ohio",12859,5798,7061
OH,39,105,"Meigs County, Ohio",5285,2498,2787
OH,39,107,"Mercer County, Ohio",3399,1428,1971
OH,39,109,"Miami County, Ohio",13076,5466,7610
OH,39,111,"Monroe County, Ohio",2782,1268,1514
OH,39,113,"Montgomery County, Ohio",96354,42909,53445
OH,39,115,"Morgan County, Ohio",3111,1481,1630
OH,39,117,"Morrow County, Ohio",4063,2119,1944
OH,39,119,"Muskingum County, Ohio",15554,7155,8399
OH,39,121,"Noble County, Ohio",1521,670,851
OH,39,123,"Ottawa County, Ohio",4349,1803,2546
OH,39,125,"Paulding County, Ohio",2436,1188,1248
OH,39,127,"Perry County, Ohio",6876,2994,3882
OH,39,129,"Pickaway County, Ohio",6509,3040,3469
OH,39,131,"Pike County, Ohio",6436,3038,3398
OH,39,133,"Portage County, Ohio",24219,10238,13981
OH,39,135,"Preble County, Ohio",5477,2504,2973
OH,39,137,"Putnam County, Ohio",1966,831,1135
OH,39,139,"Richland County, Ohio",19504,8622,10882
OH,39,141,"Ross County, Ohio",13746,6062,7684
OH,39,143,"Sandusky County, Ohio",8458,3644,4814
OH,39,145,"Scioto County, Ohio",18740,8702,10038
OH,39,147,"Seneca County, Ohio",8923,4164,4759
OH,39,149,"Shelby County, Ohio",4970,2048,2922
OH,39,151,"Stark County, Ohio",53715,23898,29817
OH,39,153,"Summit County, Ohio",78658,35036,43622
OH,39,155,"Trumbull County, Ohio",34912,15220,19692
OH,39,157,"Tuscarawas County, Ohio",12763,5748,7015
OH,39,159,"Union County, Ohio",4344,1959,2385
OH,39,161,"Van Wert County, Ohio",3600,1623,1977
OH,39,163,"Vinton County, Ohio",2713,1100,1613
OH,39,165,"Warren County, Ohio",11885,4930,6955
OH,39,167,"Washington County, Ohio",9777,4438,5339
OH,39,169,"Wayne County, Ohio",14758,6498,8260
OH,39,171,"Williams County, Ohio",5386,2265,3121
OH,39,173,"Wood County, Ohio",17461,8079,9382
OH,39,175,"Wyandot County, Ohio",2601,1060,1541
OK,40,001,"Adair County, Oklahoma",5897,2813,3084
OK,40,003,"Alfalfa County, Oklahoma",606,319,287
OK,40,005,"Atoka County, Oklahoma",2794,1204,1590
OK,40,007,"Beaver County, Oklahoma",492,182,310
OK,40,009,"Beckham County, Oklahoma",2777,1101,1676
OK,40,011,"Blaine County, Oklahoma",1293,524,769
OK,40,013,"Bryan County, Oklahoma",7816,3424,4392
OK,40,015,"Caddo County, Oklahoma",5976,2901,3075
OK,40,017,"Canadian County, Oklahoma",8995,3890,5105
OK,40,019,"Carter County, Oklahoma",7262,3135,4127
OK,40,021,"Cherokee County, Oklahoma",10426,5020,5406
OK,40,023,"Choctaw County, Oklahoma",4297,1952,2345
OK,40,025,"Cimarron County, Oklahoma",414,174,240
OK,40,027,"Cleveland County, Oklahoma",32758,15142,17616
OK,40,029,"Coal County, Oklahoma",1186,515,671
OK,40,031,"Comanche County, Oklahoma",20444,8810,11634
OK,40,033,"Cotton County, Oklahoma",1030,467,563
OK,40,035,"Craig County, Oklahoma",2659,1162,1497
OK,40,037,"Creek County, Oklahoma",10813,4877,5936
OK,40,039,"Custer County, Oklahoma",4595,2089,2506
OK,40,041,"Delaware County, Oklahoma",8311,3830,4481
OK,40,043,"Dewey County, Oklahoma",788,367,421
OK,40,045,"Ellis County, Oklahoma",595,291,304
OK,40,047,"Garfield County, Oklahoma",7852,3563,4289
OK,40,049,"Garvin County, Oklahoma",5038,2280,2758
OK,40,051,"Grady County, Oklahoma",6690,2780,3910
OK,40,053,"Grant County, Oklahoma",430,156,274
OK,40,055,"Greer County, Oklahoma",735,346,389
OK,40,057,"Harmon County, Oklahoma",481,172,309
OK,40,059,"Harper County, Oklahoma",520,272,248
OK,40,061,"Haskell County, Oklahoma",2524,1126,1398
OK,40,063,"Hughes County, Oklahoma",2244,1025,1219
OK,40,065,"Jackson County, Oklahoma",4276,1665,2611
OK,40,067,"Jefferson County, Oklahoma",1313,607,706
OK,40,069,"Johnston County, Oklahoma",2070,777,1293
OK,40,071,"Kay County, Oklahoma",8137,3467,4670
OK,40,073,"Kingfisher County, Oklahoma",1093,481,612
OK,40,075,"Kiowa County, Oklahoma",1883,806,1077
OK,40,077,"Latimer County, Oklahoma",1833,776,1057
OK,40,079,"Le Flore County, Oklahoma",11035,4903,6132
OK,40,081,"Lincoln County, Oklahoma",5335,2418,2917
OK,40,083,"Logan County, Oklahoma",4943,2388,2555
OK,40,085,"Love County, Oklahoma",1292,604,688
OK,40,087,"McClain County, Oklahoma",3944,1922,2022
OK,40,089,"McCurtain County, Oklahoma",8256,3703,4553
OK,40,091,"McIntosh County, Oklahoma",4209,1975,2234
OK,40,093,"Major County, Oklahoma",1073,456,617
OK,40,095,"Marshall County, Oklahoma",2645,1134,1511
OK,40,097,"Mayes County, Oklahoma",8585,3814,4771
OK,40,099,"Murray County, Oklahoma",2012,764,1248
OK,40,101,"Muskogee County, Oklahoma",14670,6326,8344
OK,40,103,"Noble County, Oklahoma",1515,695,820
OK,40,105,"Nowata County, Oklahoma",1928,881,1047
OK,40,107,"Okfuskee County, Oklahoma",2797,1344,1453
OK,40,109,"Oklahoma County, Oklahoma",134377,59501,74876
OK,40,111,"Okmulgee County, Oklahoma",7880,3555,4325
OK,40,113,"Osage County, Oklahoma",7365,3002,4363
OK,40,115,"Ottawa County, Oklahoma",7112,3361,3751
OK,40,117,"Pawnee County, Oklahoma",2249,980,1269
OK,40,119,"Payne County, Oklahoma",18483,9075,9408
OK,40,121,"Pittsburg County, Oklahoma",7994,3657,4337
OK,40,123,"Pontotoc County, Oklahoma",6769,3222,3547
OK,40,125,"Pottawatomie County, Oklahoma",12288,5580,6708
OK,40,127,"Pushmataha County, Oklahoma",2716,1195,1521
OK,40,129,"Roger Mills County, Oklahoma",544,246,298
OK,40,131,"Rogers County, Oklahoma",8271,3365,4906
OK,40,133,"Seminole County, Oklahoma",5371,2334,3037
OK,40,135,"Sequoyah County, Oklahoma",10261,5048,5213
OK,40,137,"Stephens County, Oklahoma",6740,2876,3864
OK,40,139,"Texas County, Oklahoma",2733,1158,1575
OK,40,141,"Tillman County, Oklahoma",1750,848,902
OK,40,143,"Tulsa County, Oklahoma",96498,42178,54320
OK,40,145,"Wagoner County, Oklahoma",8150,3605,4545
OK,40,147,"Washington County, Oklahoma",7307,3205,4102
OK,40,149,"Washita County, Oklahoma",1725,666,1059
OK,40,151,"Woods County, Oklahoma",1283,662,621
OK,40,153,"Woodward County, Oklahoma",2595,1056,1539
OR,41,001,"Baker County, Oregon",2353,1144,1209
OR,41,003,"Benton County, Oregon",18139,9502,8637
OR,41,005,"Clackamas County, Oregon",36894,16509,20385
OR,41,007,"Clatsop County, Oregon",5791,2590,3201
OR,41,009,"Columbia County, Oregon",6638,3004,3634
OR,41,011,"Coos County, Oregon",11310,5154,6156
OR,41,013,"Crook County, Oregon",4048,1787,2261
OR,41,015,"Curry County, Oregon",3682,1519,2163
OR,41,017,"Deschutes County, Oregon",24220,11509,12711
OR,41,019,"Douglas County, Oregon",20377,8874,11503
OR,41,021,"Gilliam County, Oregon",186,81,105
OR,41,023,"Grant County, Oregon",1138,508,630
OR,41,025,"Harney County, Oregon",1268,573,695
OR,41,027,"Hood River County, Oregon",3223,1435,1788
OR,41,029,"Jackson County, Oregon",39122,18447,20675
OR,41,031,"Jefferson County, Oregon",4358,2092,2266
OR,41,033,"Josephine County, Oregon",16627,8447,8180
OR,41,035,"Klamath County, Oregon",12542,5452,7090
OR,41,037,"Lake County, Oregon",1365,663,702
OR,41,039,"Lane County, Oregon",70308,34709,35599
OR,41,041,"Lincoln County, Oregon",7754,3580,4174
OR,41,043,"Linn County, Oregon",22201,9995,12206
OR,41,045,"Malheur County, Oregon",6865,2879,3986
OR,41,047,"Marion County, Oregon",57846,26573,31273
OR,41,049,"Morrow County, Oregon",1844,862,982
OR,41,051,"Multnomah County, Oregon",136472,64213,72259
OR,41,053,"Polk County, Oregon",12270,5616,6654
OR,41,055,"Sherman County, Oregon",386,170,216
OR,41,057,"Tillamook County, Oregon",4310,2086,2224
OR,41,059,"Umatilla County, Oregon",12733,5516,7217
OR,41,061,"Union County, Oregon",4641,1955,2686
OR,41,063,"Wallowa County, Oregon",1033,492,541
OR,41,065,"Wasco County, Oregon",4015,1812,2203
OR,41,067,"Washington County, Oregon",64861,29554,35307
OR,41,069,"Wheeler County, Oregon",250,107,143
OR,41,071,"Yamhill County, Oregon",15877,7131,8746
PA,42,001,"Adams County, Pennsylvania",8715,3721,4994
PA,42,003,"Allegheny County, Pennsylvania",155874,67353,88521
PA,42,005,"Armstrong County, Pennsylvania",8738,3962,4776
PA,42,007,"Beaver County, Pennsylvania",19888,8582,11306
PA,42,009,"Bedford County, Pennsylvania",6643,2986,3657
PA,42,011,"Berks County, Pennsylvania",56855,25575,31280
PA,42,013,"Blair County, Pennsylvania",18548,8198,10350
PA,42,015,"Bradford County, Pennsylvania",8336,3681,4655
PA,42,017,"Bucks County, Pennsylvania",36868,15318,21550
PA,42,019,"Butler County, Pennsylvania",16325,7113,9212
PA,42,021,"Cambria County, Pennsylvania",20011,8513,11498
PA,42,023,"Cameron County, Pennsylvania",626,217,409
PA,42,025,"Carbon County, Pennsylvania",6909,2993,3916
PA,42,027,"Centre County, Pennsylvania",27217,14043,13174
PA,42,029,"Chester County, Pennsylvania",35053,15855,19198
PA,42,031,"Clarion County, Pennsylvania",6881,3045,3836
PA,42,033,"Clearfield County, Pennsylvania",11306,5035,6271
PA,42,035,"Clinton County, Pennsylvania",6086,2474,3612
PA,42,037,"Columbia County, Pennsylvania",10067,4475,5592
PA,42,039,"Crawford County, Pennsylvania",12321,5698,6623
PA,42,041,"Cumberland County, Pennsylvania",19984,8850,11134
PA,42,043,"Dauphin County, Pennsylvania",36269,16243,20026
PA,42,045,"Delaware County, Pennsylvania",57202,25013,32189
PA,42,047,"Elk County, Pennsylvania",2721,1090,1631
PA,42,049,"Erie County, Pennsylvania",44595,19834,24761
PA,42,051,"Fayette County, Pennsylvania",25282,10838,14444
PA,42,053,"Forest County, Pennsylvania",523,245,278
PA,42,055,"Franklin County, Pennsylvania",17554,7644,9910
PA,42,057,"Fulton County, Pennsylvania",1779,763,1016
PA,42,059,"Greene County, Pennsylvania",4672,1970,2702
PA,42,061,"Huntingdon County, Pennsylvania",5578,2342,3236
PA,42,063,"Indiana County, Pennsylvania",14176,6724,7452
PA,42,065,"Jefferson County, Pennsylvania",6414,2841,3573
PA,42,067,"Juniata County, Pennsylvania",3245,1410,1835
PA,42,069,"Lackawanna County, Pennsylvania",30447,13104,17343
PA,42,071,"Lancaster County, Pennsylvania",55372,25250,30122
PA,42,073,"Lawrence County, Pennsylvania",13192,5770,7422
PA,42,075,"Lebanon County, Pennsylvania",14922,6555,8367
PA,42,077,"Lehigh County, Pennsylvania",45488,19230,26258
PA,42,079,"Luzerne County, Pennsylvania",48822,21579,27243
PA,42,081,"Lycoming County, Pennsylvania",16150,7164,8986
PA,42,083,"McKean County, Pennsylvania",6830,3230,3600
PA,42,085,"Mercer County, Pennsylvania",14549,6345,8204
PA,42,087,"Mifflin County, Pennsylvania",7216,3249,3967
PA,42,089,"Monroe County, Pennsylvania",20702,9712,10990
PA,42,091,"Montgomery County, Pennsylvania",52330,22642,29688
PA,42,093,"Montour County, Pennsylvania",1749,722,1027
PA,42,095,"Northampton County, Pennsylvania",27294,11982,15312
PA,42,097,"Northumberland County, Pennsylvania",12279,5998,6281
PA,42,099,"Perry County, Pennsylvania",4217,1783,2434
PA,42,101,"Philadelphia County, Pennsylvania",399352,178789,220563
PA,42,103,"Pike County, Pennsylvania",5532,2403,3129
PA,42,105,"Potter County, Pennsylvania",2570,1124,1446
PA,42,107,"Schuylkill County, Pennsylvania",18278,8099,10179
PA,42,109,"Snyder County, Pennsylvania",4077,1683,2394
PA,42,111,"Somerset County, Pennsylvania",9074,3689,5385
PA,42,113,"Sullivan County, Pennsylvania",802,459,343
PA,42,115,"Susquehanna County, Pennsylvania",5455,2517,2938
PA,42,117,"Tioga County, Pennsylvania",5891,2553,3338
PA,42,119,"Union County, Pennsylvania",4554,1984,2570
PA,42,121,"Venango County, Pennsylvania",8123,3615,4508
PA,42,123,"Warren County, Pennsylvania",4891,2209,2682
PA,42,125,"Washington County, Pennsylvania",21074,9161,11913
PA,42,127,"Wayne County, Pennsylvania",6164,2836,3328
PA,42,129,"Westmoreland County, Pennsylvania",36758,15792,20966
PA,42,131,"Wyoming County, Pennsylvania",3030,1313,1717
PA,42,133,"York County, Pennsylvania",46124,19823,26301
PR,72,001,"Adjuntas Municipio, Puerto Rico",11645,5455,6190
PR,72,003,"Aguada Municipio, Puerto Rico",21982,10512,11470
PR,72,005,"Aguadilla Municipio, Puerto Rico",27742,12695,15047
PR,72,007,"Aguas Buenas Municipio, Puerto Rico",14789,6917,7872
PR,72,009,"Aibonito Municipio, Puerto Rico",11713,5489,6224
PR,72,011,"Añasco Municipio, Puerto Rico",13997,6574,7423
PR,72,013,"Arecibo Municipio, Puerto Rico",45195,20489,24706
PR,72,015,"Arroyo Municipio, Puerto Rico",10020,4510,5510
PR,72,017,"Barceloneta Municipio, Puerto Rico",13828,6574,7254
PR,72,019,"Barranquitas Municipio, Puerto Rico",18032,8343,9689
PR,72,021,"Bayamón Municipio, Puerto Rico",68252,29537,38715
PR,72,023,"Cabo Rojo Municipio, Puerto Rico",25503,11897,13606
PR,72,025,"Caguas Municipio, Puerto Rico",52367,22796,29571
PR,72,027,"Camuy Municipio, Puerto Rico",16498,7478,9020
PR,72,029,"Canóvanas Municipio, Puerto Rico",20667,9113,11554
PR,72,031,"Carolina Municipio, Puerto Rico",50985,21863,29122
PR,72,033,"Cataño Municipio, Puerto Rico",13049,5704,7345
PR,72,035,"Cayey Municipio, Puerto Rico",19324,8942,10382
PR,72,037,"Ceiba Municipio, Puerto Rico",5536,2568,2968
PR,72,039,"Ciales Municipio, Puerto Rico",10642,5074,5568
PR,72,041,"Cidra Municipio, Puerto Rico",16524,7874,8650
PR,72,043,"Coamo Municipio, Puerto Rico",19842,9255,10587
PR,72,045,"Comerío Municipio, Puerto Rico",12145,5963,6182
PR,72,047,"Corozal Municipio, Puerto Rico",20237,9462,10775
PR,72,049,"Culebra Municipio, Puerto Rico",708,382,326
PR,72,051,"Dorado Municipio, Puerto Rico",13540,6342,7198
PR,72,053,"Fajardo Municipio, Puerto Rico",15660,6873,8787
PR,72,054,"Florida Municipio, Puerto Rico",6689,3046,3643
PR,72,055,"Guánica Municipio, Puerto Rico",11089,5251,5838
PR,72,057,"Guayama Municipio, Puerto Rico",22083,9715,12368
PR,72,059,"Guayanilla Municipio, Puerto Rico",11402,5477,5925
PR,72,061,"Guaynabo Municipio, Puerto Rico",25163,10955,14208
PR,72,063,"Gurabo Municipio, Puerto Rico",15848,7278,8570
PR,72,065,"Hatillo Municipio, Puerto Rico",18552,8276,10276
PR,72,067,"Hormigueros Municipio, Puerto Rico",6246,2852,3394
PR,72,069,"Humacao Municipio, Puerto Rico",25043,11650,13393
PR,72,071,"Isabela Municipio, Puerto Rico",24673,11823,12850
PR,72,073,"Jayuya Municipio, Puerto Rico",9083,4453,4630
PR,72,075,"Juana Díaz Municipio, Puerto Rico",24979,11431,13548
PR,72,077,"Juncos Municipio, Puerto Rico",18983,8642,10341
PR,72,079,"Lajas Municipio, Puerto Rico",14632,6987,7645
PR,72,081,"Lares Municipio, Puerto Rico",16529,7821,8708
PR,72,083,"Las Marías Municipio, Puerto Rico",5357,2604,2753
PR,72,085,"Las Piedras Municipio, Puerto Rico",18976,8541,10435
PR,72,087,"Loíza Municipio, Puerto Rico",13543,6252,7291
PR,72,089,"Luquillo Municipio, Puerto Rico",8868,3994,4874
PR,72,091,"Manatí Municipio, Puerto Rico",19265,8779,10486
PR,72,093,"Maricao Municipio, Puerto Rico",4054,2037,2017
PR,72,095,"Maunabo Municipio, Puerto Rico",6533,3033,3500
PR,72,097,"Mayagüez Municipio, Puerto Rico",42055,19497,22558
PR,72,099,"Moca Municipio, Puerto Rico",20947,9818,11129
PR,72,101,"Morovis Municipio, Puerto Rico",17745,8365,9380
PR,72,103,"Naguabo Municipio, Puerto Rico",14051,6311,7740
PR,72,105,"Naranjito Municipio, Puerto Rico",14616,7239,7377
PR,72,107,"Orocovis Municipio, Puerto Rico",13353,6530,6823
PR,72,109,"Patillas Municipio, Puerto Rico",10900,5158,5742
PR,72,111,"Peñuelas Municipio, Puerto Rico",13620,6609,7011
PR,72,113,"Ponce Municipio, Puerto Rico",79360,36204,43156
PR,72,115,"Quebradillas Municipio, Puerto Rico",13928,6699,7229
PR,72,117,"Rincón Municipio, Puerto Rico",7228,3421,3807
PR,72,119,"Río Grande Municipio, Puerto Rico",20341,9275,11066
PR,72,121,"Sabana Grande Municipio, Puerto Rico",11404,5649,5755
PR,72,123,"Salinas Municipio, Puerto Rico",16746,8184,8562
PR,72,125,"San Germán Municipio, Puerto Rico",17074,8219,8855
PR,72,127,"San Juan Municipio, Puerto Rico",155011,66576,88435
PR,72,129,"San Lorenzo Municipio, Puerto Rico",19157,9248,9909
PR,72,131,"San Sebastián Municipio, Puerto Rico",22775,10936,11839
PR,72,133,"Santa Isabel Municipio, Puerto Rico",11470,5403,6067
PR,72,135,"Toa Alta Municipio, Puerto Rico",23357,11176,12181
PR,72,137,"Toa Baja Municipio, Puerto Rico",32692,15220,17472
PR,72,139,"Trujillo Alto Municipio, Puerto Rico",21253,9527,11726
PR,72,141,"Utuado Municipio, Puerto Rico",16445,7737,8708
PR,72,143,"Vega Alta Municipio, Puerto Rico",19358,8901,10457
PR,72,145,"Vega Baja Municipio, Puerto Rico",27360,12767,14593
PR,72,147,"Vieques Municipio, Puerto Rico",3569,1516,2053
PR,72,149,"Villalba Municipio, Puerto Rico",13223,6382,6841
PR,72,151,"Yabucoa Municipio, Puerto Rico",18899,8668,10231
PR,72,153,"Yauco Municipio, Puerto Rico",20168,9464,10704
RI,44,001,"Bristol County, Rhode Island",3396,1458,1938
RI,44,003,"Kent County, Rhode Island",13763,5821,7942
RI,44,005,"Newport County, Rhode Island",8005,3159,4846
RI,44,007,"Providence County, Rhode Island",107120,47085,60035
RI,44,009,"Washington County, Rhode Island",11939,5494,6445
SC,45,001,"Abbeville County, South Carolina",5471,2510,2961
SC,45,003,"Aiken County, South Carolina",29126,13078,16048
SC,45,005,"Allendale County, South Carolina",2537,1164,1373
SC,45,007,"Anderson County, South Carolina",30915,13201,17714
SC,45,009,"Bamberg County, South Carolina",4077,2090,1987
SC,45,011,"Barnwell County, South Carolina",5819,2287,3532
SC,45,013,"Beaufort County, South Carolina",21221,9021,12200
SC,45,015,"Berkeley County, South Carolina",26327,11742,14585
SC,45,017,"Calhoun County, South Carolina",2896,1389,1507
SC,45,019,"Charleston County, South Carolina",62119,26269,35850
SC,45,021,"Cherokee County, South Carolina",13093,5591,7502
SC,45,023,"Chester County, South Carolina",8734,3931,4803
SC,45,025,"Chesterfield County, South Carolina",11930,6027,5903
SC,45,027,"Clarendon County, South Carolina",8163,3623,4540
SC,45,029,"Colleton County, South Carolina",8340,3466,4874
SC,45,031,"Darlington County, South Carolina",15878,6580,9298
SC,45,033,"Dillon County, South Carolina",10502,4356,6146
SC,45,035,"Dorchester County, South Carolina",18737,7557,11180
SC,45,037,"Edgefield County, South Carolina",3896,1597,2299
SC,45,039,"Fairfield County, South Carolina",5566,2255,3311
SC,45,041,"Florence County, South Carolina",26802,11243,15559
SC,45,043,"Georgetown County, South Carolina",12557,5083,7474
SC,45,045,"Greenville County, South Carolina",72169,31335,40834
SC,45,047,"Greenwood County, South Carolina",15875,6825,9050
SC,45,049,"Hampton County, South Carolina",3963,1734,2229
SC,45,051,"Horry County, South Carolina",51988,23286,28702
SC,45,053,"Jasper County, South Carolina",6106,2888,3218
SC,45,055,"Kershaw County, South Carolina",10467,4672,5795
SC,45,057,"Lancaster County, South Carolina",14802,6340,8462
SC,45,059,"Laurens County, South Carolina",13395,5938,7457
SC,45,061,"Lee County, South Carolina",4663,2202,2461
SC,45,063,"Lexington County, South Carolina",38470,16614,21856
SC,45,065,"McCormick County, South Carolina",1681,741,940
SC,45,067,"Marion County, South Carolina",8865,3480,5385
SC,45,069,"Marlboro County, South Carolina",7224,3108,4116
SC,45,071,"Newberry County, South Carolina",6436,2717,3719
SC,45,073,"Oconee County, South Carolina",14897,6520,8377
SC,45,075,"Orangeburg County, South Carolina",20600,9050,11550
SC,45,077,"Pickens County, South Carolina",22545,10766,11779
SC,45,079,"Richland County, South Carolina",62611,26738,35873
SC,45,081,"Saluda County, South Carolina",4062,1813,2249
SC,45,083,"Spartanburg County, South Carolina",49665,21832,27833
SC,45,085,"Sumter County, South Carolina",18943,8146,10797
SC,45,087,"Union County, South Carolina",5605,2257,3348
SC,45,089,"Williamsburg County, South Carolina",9349,3950,5399
SC,45,091,"York County, South Carolina",31814,13652,18162
SD,46,003,"Aurora County, South Dakota",223,105,118
SD,46,005,"Beadle County, South Dakota",3708,1647,2061
SD,46,007,"Bennett County, South Dakota",1361,631,730
SD,46,009,"Bon Homme County, South Dakota",576,268,308
SD,46,011,"Brookings County, South Dakota",4811,2411,2400
SD,46,013,"Brown County, South Dakota",3613,1635,1978
SD,46,015,"Brule County, South Dakota",789,351,438
SD,46,017,"Buffalo County, South Dakota",711,362,349
SD,46,019,"Butte County, South Dakota",1082,514,568
SD,46,021,"Campbell County, South Dakota",140,58,82
SD,46,023,"Charles Mix County, South Dakota",1970,923,1047
SD,46,025,"Clark County, South Dakota",566,285,281
SD,46,027,"Clay County, South Dakota",3255,1660,1595
SD,46,029,"Codington County, South Dakota",2806,1298,1508
SD,46,031,"Corson County, South Dakota",1865,907,958
SD,46,033,"Custer County, South Dakota",850,373,477
SD,46,035,"Davison County, South Dakota",2379,1314,1065
SD,46,037,"Day County, South Dakota",1200,559,641
SD,46,039,"Deuel County, South Dakota",330,160,170
SD,46,041,"Dewey County, South Dakota",1523,728,795
SD,46,043,"Douglas County, South Dakota",246,72,174
SD,46,045,"Edmunds County, South Dakota",479,213,266
SD,46,047,"Fall River County, South Dakota",1097,543,554
SD,46,049,"Faulk County, South Dakota",373,244,129
SD,46,051,"Grant County, South Dakota",582,228,354
SD,46,053,"Gregory County, South Dakota",769,363,406
SD,46,055,"Haakon County, South Dakota",343,181,162
SD,46,057,"Hamlin County, South Dakota",424,176,248
SD,46,059,"Hand County, South Dakota",271,138,133
SD,46,061,"Hanson County, South Dakota",406,245,161
SD,46,063,"Harding County, South Dakota",174,85,89
SD,46,065,"Hughes County, South Dakota",1663,776,887
SD,46,067,"Hutchinson County, South Dakota",926,498,428
SD,46,069,"Hyde County, South Dakota",168,74,94
SD,46,071,"Jackson County, South Dakota",1059,511,548
SD,46,073,"Jerauld County, South Dakota",176,67,109
SD,46,075,"Jones County, South Dakota",89,49,40
SD,46,077,"Kingsbury County, South Dakota",505,219,286
SD,46,079,"Lake County, South Dakota",1732,766,966
SD,46,081,"Lawrence County, South Dakota",3115,1219,1896
SD,46,083,"Lincoln County, South Dakota",2158,859,1299
SD,46,085,"Lyman County, South Dakota",775,360,415
SD,46,087,"McCook County, South Dakota",467,218,249
SD,46,089,"McPherson County, South Dakota",478,306,172
SD,46,091,"Marshall County, South Dakota",701,296,405
SD,46,093,"Meade County, South Dakota",2764,1272,1492
SD,46,095,"Mellette County, South Dakota",921,437,484
SD,46,097,"Miner County, South Dakota",234,119,115
SD,46,099,"Minnehaha County, South Dakota",20578,9155,11423
SD,46,101,"Moody County, South Dakota",910,441,469
SD,46,102,"Oglala Lakota County, South Dakota",7482,3403,4079
SD,46,103,"Pennington County, South Dakota",13079,5673,7406
SD,46,105,"Perkins County, South Dakota",396,193,203
SD,46,107,"Potter County, South Dakota",255,141,114
SD,46,109,"Roberts County, South Dakota",2031,969,1062
SD,46,111,"Sanborn County, South Dakota",238,121,117
SD,46,115,"Spink County, South Dakota",798,340,458
SD,46,117,"Stanley County, South Dakota",240,94,146
SD,46,119,"Sully County, South Dakota",74,36,38
SD,46,121,"Todd County, South Dakota",4471,2116,2355
SD,46,123,"Tripp County, South Dakota",1212,535,677
SD,46,125,"Turner County, South Dakota",761,305,456
SD,46,127,"Union County, South Dakota",783,292,491
SD,46,129,"Walworth County, South Dakota",650,241,409
SD,46,135,"Yankton County, South Dakota",2993,1298,1695
SD,46,137,"Ziebach County, South Dakota",1103,507,596
TN,47,001,"Anderson County, Tennessee",13309,5830,7479
TN,47,003,"Bedford County, Tennessee",7727,3542,4185
TN,47,005,"Benton County, Tennessee",3667,1733,1934
TN,47,007,"Bledsoe County, Tennessee",2697,1234,1463
TN,47,009,"Blount County, Tennessee",17305,7389,9916
TN,47,011,"Bradley County, Tennessee",19357,8597,10760
TN,47,013,"Campbell County, Tennessee",9203,4004,5199
TN,47,015,"Cannon County, Tennessee",2500,1154,1346
TN,47,017,"Carroll County, Tennessee",5713,2656,3057
TN,47,019,"Carter County, Tennessee",13021,6094,6927
TN,47,021,"Cheatham County, Tennessee",5396,2410,2986
TN,47,023,"Chester County, Tennessee",3516,1579,1937
TN,47,025,"Claiborne County, Tennessee",6658,2951,3707
TN,47,027,"Clay County, Tennessee",1801,820,981
TN,47,029,"Cocke County, Tennessee",9111,4022,5089
TN,47,031,"Coffee County, Tennessee",9818,4470,5348
TN,47,033,"Crockett County, Tennessee",2838,1340,1498
TN,47,035,"Cumberland County, Tennessee",9300,4080,5220
TN,47,037,"Davidson County, Tennessee",116031,52503,63528
TN,47,039,"Decatur County, Tennessee",2470,1098,1372
TN,47,041,"DeKalb County, Tennessee",3887,1562,2325
TN,47,043,"Dickson County, Tennessee",8116,3460,4656
TN,47,045,"Dyer County, Tennessee",6646,2680,3966
TN,47,047,"Fayette County, Tennessee",5351,2427,2924
TN,47,049,"Fentress County, Tennessee",4577,2281,2296
TN,47,051,"Franklin County, Tennessee",6669,2889,3780
TN,47,053,"Gibson County, Tennessee",9080,3806,5274
TN,47,055,"Giles County, Tennessee",4627,2011,2616
TN,47,057,"Grainger County, Tennessee",4647,2091,2556
TN,47,059,"Greene County, Tennessee",13647,6146,7501
TN,47,061,"Grundy County, Tennessee",3797,1683,2114
TN,47,063,"Hamblen County, Tennessee",13193,6285,6908
TN,47,065,"Hamilton County, Tennessee",54036,23604,30432
TN,47,067,"Hancock County, Tennessee",1793,706,1087
TN,47,069,"Hardeman County, Tennessee",5636,2479,3157
TN,47,071,"Hardin County, Tennessee",5920,2494,3426
TN,47,073,"Hawkins County, Tennessee",10661,4410,6251
TN,47,075,"Haywood County, Tennessee",4107,1758,2349
TN,47,077,"Henderson County, Tennessee",5925,2512,3413
TN,47,079,"Henry County, Tennessee",5862,2421,3441
TN,47,081,"Hickman County, Tennessee",4738,2218,2520
TN,47,083,"Houston County, Tennessee",1860,949,911
TN,47,085,"Humphreys County, Tennessee",2856,1312,1544
TN,47,087,"Jackson County, Tennessee",3034,1443,1591
TN,47,089,"Jefferson County, Tennessee",8343,3626,4717
TN,47,091,"Johnson County, Tennessee",4123,1916,2207
TN,47,093,"Knox County, Tennessee",69061,31168,37893
TN,47,095,"Lake County, Tennessee",1319,538,781
TN,47,097,"Lauderdale County, Tennessee",6532,2877,3655
TN,47,099,"Lawrence County, Tennessee",8443,3608,4835
TN,47,101,"Lewis County, Tennessee",2292,1189,1103
TN,47,103,"Lincoln County, Tennessee",5517,2540,2977
TN,47,105,"Loudon County, Tennessee",7185,3503,3682
TN,47,107,"McMinn County, Tennessee",10220,4598,5622
TN,47,109,"McNairy County, Tennessee",5319,2199,3120
TN,47,111,"Macon County, Tennessee",4218,1836,2382
TN,47,113,"Madison County, Tennessee",18521,7912,10609
TN,47,115,"Marion County, Tennessee",5350,2191,3159
TN,47,117,"Marshall County, Tennessee",4986,2160,2826
TN,47,119,"Maury County, Tennessee",12667,5701,6966
TN,47,121,"Meigs County, Tennessee",2377,906,1471
TN,47,123,"Monroe County, Tennessee",8627,4032,4595
TN,47,125,"Montgomery County, Tennessee",28750,12557,16193
TN,47,127,"Moore County, Tennessee",668,268,400
TN,47,129,"Morgan County, Tennessee",4185,2019,2166
TN,47,131,"Obion County, Tennessee",6309,2881,3428
TN,47,133,"Overton County, Tennessee",4668,2273,2395
TN,47,135,"Perry County, Tennessee",1995,865,1130
TN,47,137,"Pickett County, Tennessee",808,315,493
TN,47,139,"Polk County, Tennessee",3094,1481,1613
TN,47,141,"Putnam County, Tennessee",17830,8209,9621
TN,47,143,"Rhea County, Tennessee",7664,3510,4154
TN,47,145,"Roane County, Tennessee",9620,4479,5141
TN,47,147,"Robertson County, Tennessee",8005,3441,4564
TN,47,149,"Rutherford County, Tennessee",34475,15822,18653
TN,47,151,"Scott County, Tennessee",5903,2663,3240
TN,47,153,"Sequatchie County, Tennessee",2335,979,1356
TN,47,155,"Sevier County, Tennessee",14128,6136,7992
TN,47,157,"Shelby County, Tennessee",196471,87291,109180
TN,47,159,"Smith County, Tennessee",3066,1307,1759
TN,47,161,"Stewart County, Tennessee",2560,1236,1324
TN,47,163,"Sullivan County, Tennessee",26924,12365,14559
TN,47,165,"Sumner County, Tennessee",15644,6676,8968
TN,47,167,"Tipton County, Tennessee",8292,3516,4776
TN,47,169,"Trousdale County, Tennessee",1345,614,731
TN,47,171,"Unicoi County, Tennessee",3974,1790,2184
TN,47,173,"Union County, Tennessee",4036,1575,2461
TN,47,175,"Van Buren County, Tennessee",988,523,465
TN,47,177,"Warren County, Tennessee",8329,3964,4365
TN,47,179,"Washington County, Tennessee",21842,9588,12254
TN,47,181,"Wayne County, Tennessee",3211,1619,1592
TN,47,183,"Weakley County, Tennessee",6075,2810,3265
TN,47,185,"White County, Tennessee",5011,2341,2670
TN,47,187,"Williamson County, Tennessee",10054,4225,5829
TN,47,189,"Wilson County, Tennessee",12132,4886,7246
TX,48,001,"Anderson County, Texas",8274,3779,4495
TX,48,003,"Andrews County, Texas",2032,832,1200
TX,48,005,"Angelina County, Texas",16497,7061,9436
TX,48,007,"Aransas County, Texas",4509,2097,2412
TX,48,009,"Archer County, Texas",862,352,510
TX,48,011,"Armstrong County, Texas",130,49,81
TX,48,013,"Atascosa County, Texas",7619,3141,4478
TX,48,015,"Austin County, Texas",3289,1377,1912
TX,48,017,"Bailey County, Texas",1319,500,819
TX,48,019,"Bandera County, Texas",2662,1322,1340
TX,48,021,"Bastrop County, Texas",10664,4867,5797
TX,48,023,"Baylor County, Texas",423,143,280
TX,48,025,"Bee County, Texas",5274,2344,2930
TX,48,027,"Bell County, Texas",48543,21926,26617
TX,48,029,"Bexar County, Texas",312088,140680,171408
TX,48,031,"Blanco County, Texas",954,451,503
TX,48,033,"Borden County, Texas",10,5,5
TX,48,035,"Bosque County, Texas",2549,1144,1405
TX,48,037,"Bowie County, Texas",16693,7537,9156
TX,48,039,"Brazoria County, Texas",35762,16016,19746
TX,48,041,"Brazos County, Texas",53207,25213,27994
TX,48,043,"Brewster County, Texas",1238,508,730
TX,48,045,"Briscoe County, Texas",307,156,151
TX,48,047,"Brooks County, Texas",2726,1476,1250
TX,48,049,"Brown County, Texas",6581,2868,3713
TX,48,051,"Burleson County, Texas",2761,1259,1502
TX,48,053,"Burnet County, Texas",6989,3317,3672
TX,48,055,"Caldwell County, Texas",7169,3540,3629
TX,48,057,"Calhoun County, Texas",4136,1987,2149
TX,48,059,"Callahan County, Texas",2548,1107,1441
TX,48,061,"Cameron County, Texas",139768,63753,76015
TX,48,063,"Camp County, Texas",2454,1046,1408
TX,48,065,"Carson County, Texas",435,202,233
TX,48,067,"Cass County, Texas",5915,2548,3367
TX,48,069,"Castro County, Texas",1339,672,667
TX,48,071,"Chambers County, Texas",3921,1677,2244
TX,48,073,"Cherokee County, Texas",10688,4875,5813
TX,48,075,"Childress County, Texas",1177,573,604
TX,48,077,"Clay County, Texas",1246,620,626
TX,48,079,"Cochran County, Texas",591,267,324
TX,48,081,"Coke County, Texas",361,152,209
TX,48,083,"Coleman County, Texas",1924,720,1204
TX,48,085,"Collin County, Texas",64824,30107,34717
TX,48,087,"Collingsworth County, Texas",675,229,446
TX,48,089,"Colorado County, Texas",3081,1430,1651
TX,48,091,"Comal County, Texas",10423,4122,6301
TX,48,093,"Comanche County, Texas",3107,1420,1687
TX,48,095,"Concho County, Texas",298,81,217
TX,48,097,"Cooke County, Texas",5292,2322,2970
TX,48,099,"Coryell County, Texas",8631,3528,5103
TX,48,101,"Cottle County, Texas",340,167,173
TX,48,103,"Crane County, Texas",606,236,370
TX,48,105,"Crockett County, Texas",635,239,396
TX,48,107,"Crosby County, Texas",1358,544,814
TX,48,109,"Culberson County, Texas",677,307,370
TX,48,111,"Dallam County, Texas",1183,511,672
TX,48,113,"Dallas County, Texas",472926,211723,261203
TX,48,115,"Dawson County, Texas",1924,729,1195
TX,48,117,"Deaf Smith County, Texas",3955,1687,2268
TX,48,119,"Delta County, Texas",1177,554,623
TX,48,121,"Denton County, Texas",63220,27578,35642
TX,48,123,"DeWitt County, Texas",2817,1289,1528
TX,48,125,"Dickens County, Texas",417,192,225
TX,48,127,"Dimmit County, Texas",2003,721,1282
TX,48,129,"Donley County, Texas",585,247,338
TX,48,131,"Duval County, Texas",2617,1093,1524
TX,48,133,"Eastland County, Texas",3162,1312,1850
TX,48,135,"Ector County, Texas",19162,7745,11417
TX,48,137,"Edwards County, Texas",205,105,100
TX,48,139,"Ellis County, Texas",18755,8310,10445
TX,48,141,"El Paso County, Texas",185728,81700,104028
TX,48,143,"Erath County, Texas",9340,3732,5608
TX,48,145,"Falls County, Texas",3417,1589,1828
TX,48,147,"Fannin County, Texas",5305,2544,2761
TX,48,149,"Fayette County, Texas",3021,1282,1739
TX,48,151,"Fisher County, Texas",666,252,414
TX,48,153,"Floyd County, Texas",1375,613,762
TX,48,155,"Foard County, Texas",114,52,62
TX,48,157,"Fort Bend County, Texas",53761,23618,30143
TX,48,159,"Franklin County, Texas",1726,878,848
TX,48,161,"Freestone County, Texas",2683,1178,1505
TX,48,163,"Frio County, Texas",3321,1607,1714
TX,48,165,"Gaines County, Texas",2177,1018,1159
TX,48,167,"Galveston County, Texas",41985,18622,23363
TX,48,169,"Garza County, Texas",432,204,228
TX,48,171,"Gillespie County, Texas",2791,1403,1388
TX,48,173,"Glasscock County, Texas",40,20,20
TX,48,175,"Goliad County, Texas",1358,685,673
TX,48,177,"Gonzales County, Texas",4009,1702,2307
TX,48,179,"Gray County, Texas",2824,1266,1558
TX,48,181,"Grayson County, Texas",19420,8783,10637
TX,48,183,"Gregg County, Texas",21769,9209,12560
TX,48,185,"Grimes County, Texas",4701,2278,2423
TX,48,187,"Guadalupe County, Texas",13924,5939,7985
TX,48,189,"Hale County, Texas",7548,3137,4411
TX,48,191,"Hall County, Texas",844,417,427
TX,48,193,"Hamilton County, Texas",1159,545,614
TX,48,195,"Hansford County, Texas",939,455,484
TX,48,197,"Hardeman County, Texas",585,284,301
TX,48,199,"Hardin County, Texas",6684,2682,4002
TX,48,201,"Harris County, Texas",774568,348592,425976
TX,48,203,"Harrison County, Texas",11151,5009,6142
TX,48,205,"Hartley County, Texas",295,123,172
TX,48,207,"Haskell County, Texas",1030,467,563
TX,48,209,"Hays County, Texas",28783,12839,15944
TX,48,211,"Hemphill County, Texas",502,266,236
TX,48,213,"Henderson County, Texas",14572,6271,8301
TX,48,215,"Hidalgo County, Texas",277104,126943,150161
TX,48,217,"Hill County, Texas",7049,3091,3958
TX,48,219,"Hockley County, Texas",3297,1407,1890
TX,48,221,"Hood County, Texas",6161,2476,3685
TX,48,223,"Hopkins County, Texas",6972,2980,3992
TX,48,225,"Houston County, Texas",4918,1850,3068
TX,48,227,"Howard County, Texas",4787,1873,2914
TX,48,229,"Hudspeth County, Texas",1192,491,701
TX,48,231,"Hunt County, Texas",16112,7513,8599
TX,48,233,"Hutchinson County, Texas",3493,1394,2099
TX,48,235,"Irion County, Texas",191,84,107
TX,48,237,"Jack County, Texas",1324,576,748
TX,48,239,"Jackson County, Texas",1765,582,1183
TX,48,241,"Jasper County, Texas",5912,2342,3570
TX,48,243,"Jeff Davis County, Texas",123,60,63
TX,48,245,"Jefferson County, Texas",47095,19637,27458
TX,48,247,"Jim Hogg County, Texas",915,479,436
TX,48,249,"Jim Wells County, Texas",9128,4274,4854
TX,48,251,"Johnson County, Texas",18392,7958,10434
TX,48,253,"Jones County, Texas",2285,894,1391
TX,48,255,"Karnes County, Texas",3079,1427,1652
TX,48,257,"Kaufman County, Texas",15016,6368,8648
TX,48,259,"Kendall County, Texas",2862,1312,1550
TX,48,261,"Kenedy County, Texas",151,67,84
TX,48,263,"Kent County, Texas",74,31,43
TX,48,265,"Kerr County, Texas",7718,3243,4475
TX,48,267,"Kimble County, Texas",912,401,511
TX,48,269,"King County, Texas",19,10,9
TX,48,271,"Kinney County, Texas",572,280,292
TX,48,273,"Kleberg County, Texas",7849,3836,4013
TX,48,275,"Knox County, Texas",605,223,382
TX,48,277,"Lamar County, Texas",9076,3850,5226
TX,48,279,"Lamb County, Texas",3173,1511,1662
TX,48,281,"Lampasas County, Texas",2923,1347,1576
TX,48,283,"La Salle County, Texas",972,456,516
TX,48,285,"Lavaca County, Texas",1765,684,1081
TX,48,287,"Lee County, Texas",2374,1078,1296
TX,48,289,"Leon County, Texas",2322,990,1332
TX,48,291,"Liberty County, Texas",12548,5484,7064
TX,48,293,"Limestone County, Texas",5189,2600,2589
TX,48,295,"Lipscomb County, Texas",317,120,197
TX,48,297,"Live Oak County, Texas",1567,738,829
TX,48,299,"Llano County, Texas",2841,1108,1733
TX,48,301,"Loving County, Texas",33,24,9
TX,48,303,"Lubbock County, Texas",54155,24959,29196
TX,48,305,"Lynn County, Texas",1106,451,655
TX,48,307,"McCulloch County, Texas",1522,645,877
TX,48,309,"McLennan County, Texas",49881,22723,27158
TX,48,311,"McMullen County, Texas",92,45,47
TX,48,313,"Madison County, Texas",1938,925,1013
TX,48,315,"Marion County, Texas",2264,742,1522
TX,48,317,"Martin County, Texas",692,335,357
TX,48,319,"Mason County, Texas",577,284,293
TX,48,321,"Matagorda County, Texas",7833,3539,4294
TX,48,323,"Maverick County, Texas",14872,6275,8597
TX,48,325,"Medina County, Texas",6656,2989,3667
TX,48,327,"Menard County, Texas",317,114,203
TX,48,329,"Midland County, Texas",13238,5140,8098
TX,48,331,"Milam County, Texas",4159,1650,2509
TX,48,333,"Mills County, Texas",688,223,465
TX,48,335,"Mitchell County, Texas",766,274,492
TX,48,337,"Montague County, Texas",2878,1274,1604
TX,48,339,"Montgomery County, Texas",59856,27146,32710
TX,48,341,"Moore County, Texas",4421,2081,2340
TX,48,343,"Morris County, Texas",2346,1000,1346
TX,48,345,"Motley County, Texas",181,89,92
TX,48,347,"Nacogdoches County, Texas",14752,6761,7991
TX,48,349,"Navarro County, Texas",9794,4323,5471
TX,48,351,"Newton County, Texas",1798,877,921
TX,48,353,"Nolan County, Texas",3108,1410,1698
TX,48,355,"Nueces County, Texas",61965,27065,34900
TX,48,357,"Ochiltree County, Texas",1447,605,842
TX,48,359,"Oldham County, Texas",214,72,142
TX,48,361,"Orange County, Texas",12691,5723,6968
TX,48,363,"Palo Pinto County, Texas",5425,2473,2952
TX,48,365,"Panola County, Texas",3509,1196,2313
TX,48,367,"Parker County, Texas",11785,4602,7183
TX,48,369,"Parmer County, Texas",1696,751,945
TX,48,371,"Pecos County, Texas",1643,728,915
TX,48,373,"Polk County, Texas",7279,3252,4027
TX,48,375,"Potter County, Texas",25466,10956,14510
TX,48,377,"Presidio County, Texas",1586,643,943
TX,48,379,"Rains County, Texas",1206,514,692
TX,48,381,"Randall County, Texas",13076,5425,7651
TX,48,383,"Reagan County, Texas",552,277,275
TX,48,385,"Real County, Texas",541,242,299
TX,48,387,"Red River County, Texas",2321,1053,1268
TX,48,389,"Reeves County, Texas",1895,825,1070
TX,48,391,"Refugio County, Texas",1203,573,630
TX,48,393,"Roberts County, Texas",14,9,5
TX,48,395,"Robertson County, Texas",2841,1286,1555
TX,48,397,"Rockwall County, Texas",5310,2397,2913
TX,48,399,"Runnels County, Texas",2071,964,1107
TX,48,401,"Rusk County, Texas",8510,3598,4912
TX,48,403,"Sabine County, Texas",2840,1363,1477
TX,48,405,"San Augustine County, Texas",2105,978,1127
TX,48,407,"San Jacinto County, Texas",5419,2160,3259
TX,48,409,"San Patricio County, Texas",9949,4153,5796
TX,48,411,"San Saba County, Texas",792,416,376
TX,48,413,"Schleicher County, Texas",630,214,416
TX,48,415,"Scurry County, Texas",1527,555,972
TX,48,417,"Shackelford County, Texas",635,340,295
TX,48,419,"Shelby County, Texas",5553,2706,2847
TX,48,421,"Sherman County, Texas",376,117,259
TX,48,423,"Smith County, Texas",37048,16944,20104
TX,48,425,"Somervell County, Texas",1158,406,752
TX,48,427,"Starr County, Texas",22663,9955,12708
TX,48,429,"Stephens County, Texas",1751,749,1002
TX,48,431,"Sterling County, Texas",208,100,108
TX,48,433,"Stonewall County, Texas",264,155,109
TX,48,435,"Sutton County, Texas",328,151,177
TX,48,437,"Swisher County, Texas",1595,708,887
TX,48,439,"Tarrant County, Texas",283264,129036,154228
TX,48,441,"Taylor County, Texas",22395,9712,12683
TX,48,443,"Terrell County, Texas",186,58,128
TX,48,445,"Terry County, Texas",1756,726,1030
TX,48,447,"Throckmorton County, Texas",199,81,118
TX,48,449,"Titus County, Texas",6848,3136,3712
TX,48,451,"Tom Green County, Texas",16202,7037,9165
TX,48,453,"Travis County, Texas",180220,84267,95953
TX,48,455,"Trinity County, Texas",2381,1166,1215
TX,48,457,"Tyler County, Texas",3159,1489,1670
TX,48,459,"Upshur County, Texas",5322,2251,3071
TX,48,461,"Upton County, Texas",657,278,379
TX,48,463,"Uvalde County, Texas",5248,2307,2941
TX,48,465,"Val Verde County, Texas",9738,4303,5435
TX,48,467,"Van Zandt County, Texas",8787,3991,4796
TX,48,469,"Victoria County, Texas",14531,6219,8312
TX,48,471,"Walker County, Texas",12642,5139,7503
TX,48,473,"Waller County, Texas",7505,3529,3976
TX,48,475,"Ward County, Texas",1831,905,926
TX,48,477,"Washington County, Texas",4325,1895,2430
TX,48,479,"Webb County, Texas",82307,36856,45451
TX,48,481,"Wharton County, Texas",7178,3232,3946
TX,48,483,"Wheeler County, Texas",862,419,443
TX,48,485,"Wichita County, Texas",20712,8817,11895
TX,48,487,"Wilbarger County, Texas",2275,1155,1120
TX,48,489,"Willacy County, Texas",7604,3426,4178
TX,48,491,"Williamson County, Texas",35014,15936,19078
TX,48,493,"Wilson County, Texas",4783,2127,2656
TX,48,495,"Winkler County, Texas",1040,370,670
TX,48,497,"Wise County, Texas",7015,2646,4369
TX,48,499,"Wood County, Texas",6073,2621,3452
TX,48,501,"Yoakum County, Texas",979,308,671
TX,48,503,"Young County, Texas",2751,1308,1443
TX,48,505,"Zapata County, Texas",5334,2552,2782
TX,48,507,"Zavala County, Texas",3943,1409,2534
UT,49,001,"Beaver County, Utah",797,374,423
UT,49,003,"Box Elder County, Utah",4779,2317,2462
UT,49,005,"Cache County, Utah",17713,8262,9451
UT,49,007,"Carbon County, Utah",3113,1350,1763
UT,49,009,"Daggett County, Utah",47,11,36
UT,49,011,"Davis County, Utah",24718,10960,13758
UT,49,013,"Duchesne County, Utah",2019,821,1198
UT,49,015,"Emery County, Utah",1188,482,706
UT,49,017,"Garfield County, Utah",873,358,515
UT,49,019,"Grand County, Utah",1740,877,863
UT,49,021,"Iron County, Utah",9727,4998,4729
UT,49,023,"Juab County, Utah",1464,746,718
UT,49,025,"Kane County, Utah",562,233,329
UT,49,027,"Millard County, Utah",1602,713,889
UT,49,029,"Morgan County, Utah",557,262,295
UT,49,031,"Piute County, Utah",376,190,186
UT,49,033,"Rich County, Utah",333,115,218
UT,49,035,"Salt Lake County, Utah",131630,61427,70203
UT,49,037,"San Juan County, Utah",4149,1972,2177
UT,49,039,"Sanpete County, Utah",4043,1618,2425
UT,49,041,"Sevier County, Utah",2973,1222,1751
UT,49,043,"Summit County, Utah",3001,1546,1455
UT,49,045,"Tooele County, Utah",4339,1877,2462
UT,49,047,"Uintah County, Utah",3261,1530,1731
UT,49,049,"Utah County, Utah",71110,33388,37722
UT,49,051,"Wasatch County, Utah",2633,1199,1434
UT,49,053,"Washington County, Utah",21893,10244,11649
UT,49,055,"Wayne County, Utah",414,214,200
UT,49,057,"Weber County, Utah",30547,14446,16101
VA,51,001,"Accomack County, Virginia",6384,2475,3909
VA,51,003,"Albemarle County, Virginia",9714,4431,5283
VA,51,005,"Alleghany County, Virginia",2682,1184,1498
VA,51,007,"Amelia County, Virginia",1471,792,679
VA,51,009,"Amherst County, Virginia",4086,2099,1987
VA,51,011,"Appomattox County, Virginia",2668,1172,1496
VA,51,013,"Arlington County, Virginia",19996,9134,10862
VA,51,015,"Augusta County, Virginia",6694,2535,4159
VA,51,017,"Bath County, Virginia",347,185,162
VA,51,019,"Bedford County, Virginia",7372,3436,3936
VA,51,021,"Bland County, Virginia",621,287,334
VA,51,023,"Botetourt County, Virginia",2701,1248,1453
VA,51,025,"Brunswick County, Virginia",3298,1396,1902
VA,51,027,"Buchanan County, Virginia",5841,2717,3124
VA,51,029,"Buckingham County, Virginia",2867,1283,1584
VA,51,031,"Campbell County, Virginia",7309,3096,4213
VA,51,033,"Caroline County, Virginia",3601,1521,2080
VA,51,035,"Carroll County, Virginia",5017,2237,2780
VA,51,036,"Charles City County, Virginia",933,379,554
VA,51,037,"Charlotte County, Virginia",2589,1050,1539
VA,51,041,"Chesterfield County, Virginia",24002,10156,13846
VA,51,043,"Clarke County, Virginia",1556,734,822
VA,51,045,"Craig County, Virginia",611,218,393
VA,51,047,"Culpeper County, Virginia",4320,1806,2514
VA,51,049,"Cumberland County, Virginia",1996,1065,931
VA,51,051,"Dickenson County, Virginia",3225,1513,1712
VA,51,053,"Dinwiddie County, Virginia",4061,1686,2375
VA,51,057,"Essex County, Virginia",1533,584,949
VA,51,059,"Fairfax County, Virginia",66762,29498,37264
VA,51,061,"Fauquier County, Virginia",3762,1662,2100
VA,51,063,"Floyd County, Virginia",1551,803,748
VA,51,065,"Fluvanna County, Virginia",1618,666,952
VA,51,067,"Franklin County, Virginia",8123,3695,4428
VA,51,069,"Frederick County, Virginia",5247,2162,3085
VA,51,071,"Giles County, Virginia",1891,851,1040
VA,51,073,"Gloucester County, Virginia",2735,1165,1570
VA,51,075,"Goochland County, Virginia",1163,520,643
VA,51,077,"Grayson County, Virginia",3244,1359,1885
VA,51,079,"Greene County, Virginia",1853,751,1102
VA,51,081,"Greensville County, Virginia",1490,497,993
VA,51,083,"Halifax County, Virginia",6675,3041,3634
VA,51,085,"Hanover County, Virginia",5976,2392,3584
VA,51,087,"Henrico County, Virginia",33914,14118,19796
VA,51,089,"Henry County, Virginia",9520,4167,5353
VA,51,091,"Highland County, Virginia",282,88,194
VA,51,093,"Isle of Wight County, Virginia",4137,1943,2194
VA,51,095,"James City County, Virginia",5648,2559,3089
VA,51,097,"King and Queen County, Virginia",949,470,479
VA,51,099,"King George County, Virginia",1366,522,844
VA,51,101,"King William County, Virginia",1897,835,1062
VA,51,103,"Lancaster County, Virginia",1246,551,695
VA,51,105,"Lee County, Virginia",6027,2490,3537
VA,51,107,"Loudoun County, Virginia",14047,5850,8197
VA,51,109,"Louisa County, Virginia",3385,1584,1801
VA,51,111,"Lunenburg County, Virginia",2279,1015,1264
VA,51,113,"Madison County, Virginia",1613,725,888
VA,51,115,"Mathews County, Virginia",613,274,339
VA,51,117,"Mecklenburg County, Virginia",5975,2697,3278
VA,51,119,"Middlesex County, Virginia",982,462,520
VA,51,121,"Montgomery County, Virginia",21707,11805,9902
VA,51,125,"Nelson County, Virginia",2159,1131,1028
VA,51,127,"New Kent County, Virginia",1327,485,842
VA,51,131,"Northampton County, Virginia",2730,1193,1537
VA,51,133,"Northumberland County, Virginia",1352,537,815
VA,51,135,"Nottoway County, Virginia",3444,1760,1684
VA,51,137,"Orange County, Virginia",4105,1637,2468
VA,51,139,"Page County, Virginia",3880,1813,2067
VA,51,141,"Patrick County, Virginia",3818,1918,1900
VA,51,143,"Pittsylvania County, Virginia",9944,3897,6047
VA,51,145,"Powhatan County, Virginia",1252,476,776
VA,51,147,"Prince Edward County, Virginia",3883,1503,2380
VA,51,149,"Prince George County, Virginia",3370,1612,1758
VA,51,153,"Prince William County, Virginia",28739,12982,15757
VA,51,155,"Pulaski County, Virginia",4506,2063,2443
VA,51,157,"Rappahannock County, Virginia",733,323,410
VA,51,159,"Richmond County, Virginia",748,289,459
VA,51,161,"Roanoke County, Virginia",7607,3482,4125
VA,51,163,"Rockbridge County, Virginia",3085,1379,1706
VA,51,165,"Rockingham County, Virginia",8471,3839,4632
VA,51,167,"Russell County, Virginia",5777,2322,3455
VA,51,169,"Scott County, Virginia",4406,1945,2461
VA,51,171,"Shenandoah County, Virginia",5138,2009,3129
VA,51,173,"Smyth County, Virginia",5815,2757,3058
VA,51,175,"Southampton County, Virginia",2649,1175,1474
VA,51,177,"Spotsylvania County, Virginia",10396,4565,5831
VA,51,179,"Stafford County, Virginia",6948,2928,4020
VA,51,181,"Surry County, Virginia",881,403,478
VA,51,183,"Sussex County, Virginia",1362,439,923
VA,51,185,"Tazewell County, Virginia",7518,3186,4332
VA,51,187,"Warren County, Virginia",3696,1533,2163
VA,51,191,"Washington County, Virginia",6845,3161,3684
VA,51,193,"Westmoreland County, Virginia",2323,1045,1278
VA,51,195,"Wise County, Virginia",8414,3646,4768
VA,51,197,"Wythe County, Virginia",4356,2050,2306
VA,51,199,"York County, Virginia",4198,1815,2383
VA,51,510,"Alexandria city, Virginia",12359,4903,7456
VA,51,520,"Bristol city, Virginia",3496,1410,2086
VA,51,530,"Buena Vista city, Virginia",1755,529,1226
VA,51,540,"Charlottesville city, Virginia",10995,5182,5813
VA,51,550,"Chesapeake city, Virginia",21734,8627,13107
VA,51,570,"Colonial Heights city, Virginia",1974,837,1137
VA,51,580,"Covington city, Virginia",1437,587,850
VA,51,590,"Danville city, Virginia",9629,4000,5629
VA,51,595,"Emporia city, Virginia",1907,862,1045
VA,51,600,"Fairfax city, Virginia",1593,831,762
VA,51,610,"Falls Church city, Virginia",361,124,237
VA,51,620,"Franklin city, Virginia",1762,962,800
VA,51,630,"Fredericksburg city, Virginia",4108,1727,2381
VA,51,640,"Galax city, Virginia",1766,913,853
VA,51,650,"Hampton city, Virginia",20187,8590,11597
VA,51,660,"Harrisonburg city, Virginia",14326,6628,7698
VA,51,670,"Hopewell city, Virginia",4165,1792,2373
VA,51,678,"Lexington city, Virginia",678,205,473
VA,51,680,"Lynchburg city, Virginia",16775,7243,9532
VA,51,683,"Manassas city, Virginia",3945,1572,2373
VA,51,685,"Manassas Park city, Virginia",1232,646,586
VA,51,690,"Martinsville city, Virginia",3105,1269,1836
VA,51,700,"Newport News city, Virginia",26984,11787,15197
VA,51,710,"Norfolk city, Virginia",46288,21633,24655
VA,51,720,"Norton city, Virginia",949,369,580
VA,51,730,"Petersburg city, Virginia",8795,3584,5211
VA,51,735,"Poquoson city, Virginia",502,134,368
VA,51,740,"Portsmouth city, Virginia",17000,6563,10437
VA,51,750,"Radford city, Virginia",5497,2608,2889
VA,51,760,"Richmond city, Virginia",51828,22792,29036
VA,51,770,"Roanoke city, Virginia",20514,8945,11569
VA,51,775,"Salem city, Virginia",2578,1082,1496
VA,51,790,"Staunton city, Virginia",4052,1677,2375
VA,51,800,"Suffolk city, Virginia",9835,4190,5645
VA,51,810,"Virginia Beach city, Virginia",36267,15055,21212
VA,51,820,"Waynesboro city, Virginia",3796,1496,2300
VA,51,830,"Williamsburg city, Virginia",2401,1108,1293
VA,51,840,"Winchester city, Virginia",4200,1784,2416
VT,50,001,"Addison County, Vermont",3124,1498,1626
VT,50,003,"Bennington County, Vermont",4735,2226,2509
VT,50,005,"Caledonia County, Vermont",3733,1458,2275
VT,50,007,"Chittenden County, Vermont",17045,7513,9532
VT,50,009,"Essex County, Vermont",929,412,517
VT,50,011,"Franklin County, Vermont",4147,1893,2254
VT,50,013,"Grand Isle County, Vermont",598,275,323
VT,50,015,"Lamoille County, Vermont",2887,1126,1761
VT,50,017,"Orange County, Vermont",3498,1601,1897
VT,50,019,"Orleans County, Vermont",4070,1866,2204
VT,50,021,"Rutland County, Vermont",7276,3507,3769
VT,50,023,"Washington County, Vermont",5729,2530,3199
VT,50,025,"Windham County, Vermont",5421,2361,3060
VT,50,027,"Windsor County, Vermont",6041,2725,3316
WA,53,001,"Adams County, Washington",4019,1948,2071
WA,53,003,"Asotin County, Washington",3301,1474,1827
WA,53,005,"Benton County, Washington",26013,11805,14208
WA,53,007,"Chelan County, Washington",10466,4799,5667
WA,53,009,"Clallam County, Washington",10682,4864,5818
WA,53,011,"Clark County, Washington",49314,21861,27453
WA,53,013,"Columbia County, Washington",690,357,333
WA,53,015,"Cowlitz County, Washington",17609,8049,9560
WA,53,017,"Douglas County, Washington",5835,2677,3158
WA,53,019,"Ferry County, Washington",1659,906,753
WA,53,021,"Franklin County, Washington",15406,7067,8339
WA,53,023,"Garfield County, Washington",252,95,157
WA,53,025,"Grant County, Washington",16295,7498,8797
WA,53,027,"Grays Harbor County, Washington",12357,5580,6777
WA,53,029,"Island County, Washington",7430,3115,4315
WA,53,031,"Jefferson County, Washington",3508,1500,2008
WA,53,033,"King County, Washington",226204,105541,120663
WA,53,035,"Kitsap County, Washington",26349,11851,14498
WA,53,037,"Kittitas County, Washington",8804,3868,4936
WA,53,039,"Klickitat County, Washington",3150,1141,2009
WA,53,041,"Lewis County, Washington",12126,5448,6678
WA,53,043,"Lincoln County, Washington",1562,720,842
WA,53,045,"Mason County, Washington",10166,5632,4534
WA,53,047,"Okanogan County, Washington",8646,4399,4247
WA,53,049,"Pacific County, Washington",3918,1788,2130
WA,53,051,"Pend Oreille County, Washington",2753,1293,1460
WA,53,053,"Pierce County, Washington",102233,45865,56368
WA,53,055,"San Juan County, Washington",1823,731,1092
WA,53,057,"Skagit County, Washington",18815,8499,10316
WA,53,059,"Skamania County, Washington",1526,627,899
WA,53,061,"Snohomish County, Washington",74826,33579,41247
WA,53,063,"Spokane County, Washington",74110,35552,38558
WA,53,065,"Stevens County, Washington",7753,3573,4180
WA,53,067,"Thurston County, Washington",32101,14506,17595
WA,53,069,"Wahkiakum County, Washington",674,298,376
WA,53,071,"Walla Walla County, Washington",9535,4153,5382
WA,53,073,"Whatcom County, Washington",32328,14556,17772
WA,53,075,"Whitman County, Washington",12580,6698,5882
WA,53,077,"Yakima County, Washington",51694,23973,27721
WI,55,001,"Adams County, Wisconsin",2704,1437,1267
WI,55,003,"Ashland County, Wisconsin",2398,1017,1381
WI,55,005,"Barron County, Wisconsin",5640,2618,3022
WI,55,007,"Bayfield County, Wisconsin",1719,772,947
WI,55,009,"Brown County, Wisconsin",28969,12381,16588
WI,55,011,"Buffalo County, Wisconsin",1500,716,784
WI,55,013,"Burnett County, Wisconsin",2371,1171,1200
WI,55,015,"Calumet County, Wisconsin",3434,1377,2057
WI,55,017,"Chippewa County, Wisconsin",6081,2915,3166
WI,55,019,"Clark County, Wisconsin",5504,2419,3085
WI,55,021,"Columbia County, Wisconsin",4844,2124,2720
WI,55,023,"Crawford County, Wisconsin",2023,869,1154
WI,55,025,"Dane County, Wisconsin",64062,28989,35073
WI,55,027,"Dodge County, Wisconsin",7658,3436,4222
WI,55,029,"Door County, Wisconsin",2766,1255,1511
WI,55,031,"Douglas County, Wisconsin",6713,3156,3557
WI,55,033,"Dunn County, Wisconsin",6140,2632,3508
WI,55,035,"Eau Claire County, Wisconsin",14862,6739,8123
WI,55,037,"Florence County, Wisconsin",409,160,249
WI,55,039,"Fond du Lac County, Wisconsin",9071,3932,5139
WI,55,041,"Forest County, Wisconsin",1505,729,776
WI,55,043,"Grant County, Wisconsin",7318,3707,3611
WI,55,045,"Green County, Wisconsin",3253,1413,1840
WI,55,047,"Green Lake County, Wisconsin",2274,1143,1131
WI,55,049,"Iowa County, Wisconsin",2448,1154,1294
WI,55,051,"Iron County, Wisconsin",653,277,376
WI,55,053,"Jackson County, Wisconsin",2810,1234,1576
WI,55,055,"Jefferson County, Wisconsin",8597,3917,4680
WI,55,057,"Juneau County, Wisconsin",3567,1754,1813
WI,55,059,"Kenosha County, Wisconsin",24823,11271,13552
WI,55,061,"Kewaunee County, Wisconsin",1800,762,1038
WI,55,063,"La Crosse County, Wisconsin",16616,7106,9510
WI,55,065,"Lafayette County, Wisconsin",1800,809,991
WI,55,067,"Langlade County, Wisconsin",3063,1523,1540
WI,55,069,"Lincoln County, Wisconsin",2800,1249,1551
WI,55,071,"Manitowoc County, Wisconsin",7957,3304,4653
WI,55,073,"Marathon County, Wisconsin",14095,6537,7558
WI,55,075,"Marinette County, Wisconsin",5168,2229,2939
WI,55,077,"Marquette County, Wisconsin",2069,994,1075
WI,55,078,"Menominee County, Wisconsin",1535,735,800
WI,55,079,"Milwaukee County, Wisconsin",201124,91053,110071
WI,55,081,"Monroe County, Wisconsin",6676,3011,3665
WI,55,083,"Oconto County, Wisconsin",3466,1682,1784
WI,55,085,"Oneida County, Wisconsin",3632,1646,1986
WI,55,087,"Outagamie County, Wisconsin",15723,7230,8493
WI,55,089,"Ozaukee County, Wisconsin",4467,1716,2751
WI,55,091,"Pepin County, Wisconsin",947,403,544
WI,55,093,"Pierce County, Wisconsin",4615,2047,2568
WI,55,095,"Polk County, Wisconsin",4407,1978,2429
WI,55,097,"Portage County, Wisconsin",10095,5009,5086
WI,55,099,"Price County, Wisconsin",1860,888,972
WI,55,101,"Racine County, Wisconsin",23768,9979,13789
WI,55,103,"Richland County, Wisconsin",2609,1271,1338
WI,55,105,"Rock County, Wisconsin",23498,10753,12745
WI,55,107,"Rusk County, Wisconsin",2252,1121,1131
WI,55,109,"St. Croix County, Wisconsin",5502,2468,3034
WI,55,111,"Sauk County, Wisconsin",7656,3355,4301
WI,55,113,"Sawyer County, Wisconsin",2673,1195,1478
WI,55,115,"Shawano County, Wisconsin",4451,1998,2453
WI,55,117,"Sheboygan County, Wisconsin",10348,4731,5617
WI,55,119,"Taylor County, Wisconsin",2527,1150,1377
WI,55,121,"Trempealeau County, Wisconsin",3078,1355,1723
WI,55,123,"Vernon County, Wisconsin",4757,2125,2632
WI,55,125,"Vilas County, Wisconsin",3047,1365,1682
WI,55,127,"Walworth County, Wisconsin",13499,5855,7644
WI,55,129,"Washburn County, Wisconsin",2022,911,1111
WI,55,131,"Washington County, Wisconsin",7375,2950,4425
WI,55,133,"Waukesha County, Wisconsin",20433,8852,11581
WI,55,135,"Waupaca County, Wisconsin",5232,2328,2904
WI,55,137,"Waushara County, Wisconsin",2385,1092,1293
WI,55,139,"Winnebago County, Wisconsin",19209,8291,10918
WI,55,141,"Wood County, Wisconsin",7996,3644,4352
WV,54,001,"Barbour County, West Virginia",3482,1682,1800
WV,54,003,"Berkeley County, West Virginia",15235,6801,8434
WV,54,005,"Boone County, West Virginia",5529,2643,2886
WV,54,007,"Braxton County, West Virginia",2941,1496,1445
WV,54,009,"Brooke County, West Virginia",2960,1290,1670
WV,54,011,"Cabell County, West Virginia",20110,8964,11146
WV,54,013,"Calhoun County, West Virginia",1314,569,745
WV,54,015,"Clay County, West Virginia",2530,1119,1411
WV,54,017,"Doddridge County, West Virginia",1190,457,733
WV,54,019,"Fayette County, West Virginia",8683,3956,4727
WV,54,021,"Gilmer County, West Virginia",1781,977,804
WV,54,023,"Grant County, West Virginia",1791,882,909
WV,54,025,"Greenbrier County, West Virginia",6530,2939,3591
WV,54,027,"Hampshire County, West Virginia",4721,2317,2404
WV,54,029,"Hancock County, West Virginia",4835,2034,2801
WV,54,031,"Hardy County, West Virginia",1863,773,1090
WV,54,033,"Harrison County, West Virginia",11072,4992,6080
WV,54,035,"Jackson County, West Virginia",4743,2268,2475
WV,54,037,"Jefferson County, West Virginia",6222,2521,3701
WV,54,039,"Kanawha County, West Virginia",29703,13258,16445
WV,54,041,"Lewis County, West Virginia",3357,1583,1774
WV,54,043,"Lincoln County, West Virginia",5870,2758,3112
WV,54,045,"Logan County, West Virginia",6902,2915,3987
WV,54,047,"McDowell County, West Virginia",6943,3196,3747
WV,54,049,"Marion County, West Virginia",8980,4005,4975
WV,54,051,"Marshall County, West Virginia",4128,1676,2452
WV,54,053,"Mason County, West Virginia",5075,2409,2666
WV,54,055,"Mercer County, West Virginia",13236,5322,7914
WV,54,057,"Mineral County, West Virginia",4562,2071,2491
WV,54,059,"Mingo County, West Virginia",6654,2873,3781
WV,54,061,"Monongalia County, West Virginia",20923,10509,10414
WV,54,063,"Monroe County, West Virginia",2252,894,1358
WV,54,065,"Morgan County, West Virginia",2218,879,1339
WV,54,067,"Nicholas County, West Virginia",4636,2006,2630
WV,54,069,"Ohio County, West Virginia",6658,2958,3700
WV,54,071,"Pendleton County, West Virginia",1500,776,724
WV,54,073,"Pleasants County, West Virginia",1260,616,644
WV,54,075,"Pocahontas County, West Virginia",1382,568,814
WV,54,077,"Preston County, West Virginia",4574,2002,2572
WV,54,079,"Putnam County, West Virginia",5494,2026,3468
WV,54,081,"Raleigh County, West Virginia",13322,5897,7425
WV,54,083,"Randolph County, West Virginia",4610,1968,2642
WV,54,085,"Ritchie County, West Virginia",2071,995,1076
WV,54,087,"Roane County, West Virginia",3165,1382,1783
WV,54,089,"Summers County, West Virginia",2184,1100,1084
WV,54,091,"Taylor County, West Virginia",2731,1296,1435
WV,54,093,"Tucker County, West Virginia",1013,450,563
WV,54,095,"Tyler County, West Virginia",1765,675,1090
WV,54,097,"Upshur County, West Virginia",4189,1928,2261
WV,54,099,"Wayne County, West Virginia",8468,3971,4497
WV,54,101,"Webster County, West Virginia",2307,1033,1274
WV,54,103,"Wetzel County, West Virginia",3169,1354,1815
WV,54,105,"Wirt County, West Virginia",792,291,501
WV,54,107,"Wood County, West Virginia",14825,6309,8516
WV,54,109,"Wyoming County, West Virginia",4934,2320,2614
WY,56,001,"Albany County, Wyoming",9510,4748,4762
WY,56,003,"Big Horn County, Wyoming",1408,632,776
WY,56,005,"Campbell County, Wyoming",3412,1380,2032
WY,56,007,"Carbon County, Wyoming",2280,948,1332
WY,56,009,"Converse County, Wyoming",1308,486,822
WY,56,011,"Crook County, Wyoming",362,206,156
WY,56,013,"Fremont County, Wyoming",5637,2586,3051
WY,56,015,"Goshen County, Wyoming",2261,1048,1213
WY,56,017,"Hot Springs County, Wyoming",500,140,360
WY,56,019,"Johnson County, Wyoming",534,294,240
WY,56,021,"Laramie County, Wyoming",9369,3777,5592
WY,56,023,"Lincoln County, Wyoming",1435,662,773
WY,56,025,"Natrona County, Wyoming",8407,3605,4802
WY,56,027,"Niobrara County, Wyoming",328,154,174
WY,56,029,"Park County, Wyoming",2024,492,1532
WY,56,031,"Platte County, Wyoming",1391,562,829
WY,56,033,"Sheridan County, Wyoming",2381,1210,1171
WY,56,035,"Sublette County, Wyoming",812,453,359
WY,56,037,"Sweetwater County, Wyoming",5058,2177,2881
WY,56,039,"Teton County, Wyoming",1638,1026,612
WY,56,041,"Uinta County, Wyoming",2845,1453,1392
WY,56,043,"Washakie County, Wyoming",1137,489,648
WY,56,045,"Weston County, Wyoming",958,354,604
